AAE: ['AAHED', 'ABASE', 'ABATE', 'ADAGE', 'AGAPE', 'AGATE', 'AGAVE', 'AGAZE', 'ALANE', 'ALATE', 'ALGAE', 'AMAZE', 'ANSAE', 'ANTAE', 'APACE', 'ARAME', 'AWAKE', 'AWARE', 'BAAED', 'PARAE'] 
AAII: ['AALII'] 
AA: ['AARGH', 'ABACK', 'ABAFT', 'ABAMP', 'ABASH', 'ABBAS', 'ADAPT', 'ADDAX', 'ADMAN', 'AFARS', 'AGARS', 'AGHAS', 'AGMAS', 'ALACK', 'ALAND', 'ALANG', 'ALANS', 'ALANT', 'ALARM', 'ALBAS', 'ALFAS', 'ALGAL', 'ALGAS', 'ALMAH', 'ALMAS', 'ALPHA', 'ALTAR', 'AMAHS', 'AMASS', 'ANGAS', 'ANLAS', 'ANNAL', 'ANNAS', 'ANTAS', 'ANTRA', 'APART', 'APPAL', 'ARAKS', 'ARGAL', 'ARHAT', 'ARRAS', 'ARTAL', 'ARVAL', 'ATAPS', 'ATLAS', 'ATMAN', 'ATMAS', 'ATTAR', 'AVANT', 'AVAST', 'AVGAS', 'AWARD', 'AWASH', 'AXMAN', 'AZANS', 'BAALS', 'BABAS', 'BABKA', 'BACCA', 'BALAS', 'BALSA', 'BANAL', 'BANDA', 'BARCA', 'BASAL', 'BAZAR', 'BRAVA', 'BRAZA', 'BWANA', 'CABAL', 'CACAS', 'CALLA', 'CAMAS', 'CANAL', 'CANNA', 'CARAT', 'CASAS', 'CRAAL', 'DACHA', 'DADAS', 'DAGGA', 'DAMAN', 'DAMAR', 'DRAMA', 'FANGA', 'FARAD', 'FATAL', 'FATWA', 'FAVAS', 'GALAH', 'GALAS', 'GALAX', 'GAMAS', 'GAMBA', 'GAMMA', 'GANJA', 'GARDA', 'GAZAR', 'GRAAL', 'GRAMA', 'GRANA', 'HAAFS', 'HAARS', 'HADAL', 'HAHAS', 'HALAL', 'HALMA', 'HALVA', 'HAMAL', 'HAMZA', 'HANSA', 'HAPAX', 'HAZAN', 'JACAL', 'JAGRA', 'JALAP', 'JAPAN', 'JAVAS', 'JAWAN', 'JNANA', 'KABAB', 'KABAR', 'KAKAS', 'KALAM', 'KALPA', 'KANAS', 'KAPAS', 'KAPPA', 'KARAT', 'KARMA', 'KASHA', 'KATAS', 'KAVAS', 'KRAAL', 'LABRA', 'LAGAN', 'LAHAR', 'LAMAS', 'LARVA', 'LAVAS', 'LAZAR', 'LLAMA', 'MAARS', 'MACAW', 'MADAM', 'MAGMA', 'MAKAR', 'MALAR', 'MAMAS', 'MAMBA', 'MAMMA', 'MANAS', 'MANAT', 'MANGA', 'MANNA', 'MANTA', 'MARAS', 'MARKA', 'MASAS', 'MASSA', 'MATZA', 'NAANS', 'NADAS', 'NAKFA', 'NALAS', 'NANAS', 'NAPAS', 'NAPPA', 'NASAL', 'NATAL', 'NAVAL', 'NAVAR', 'NAWAB', 'PACAS', 'PACHA', 'PAGAN', 'PAMPA', 'PANDA', 'PANGA', 'PAPAL', 'PAPAS', 'PAPAW', 'PARAS', 'PARKA', 'PASHA', 'PASTA', 'PAVAN', 'PLAZA', 'PRAAM', 'QANAT', 'RABAT', 'RADAR', 'RAGAS', 'RAJAH', 'RAJAS', 'RAMAL', 'RATAL', 'RATAN', 'SABAL', 'SABRA', 'SACRA', 'SAGAS', 'SALAD', 'SALAL', 'SALPA', 'SALSA', 'SAMBA', 'SANGA', 'SARAN', 'TABLA', 'TAKAS', 'TALAR', 'TALAS', 'TAMAL', 'TANGA', 'TANKA', 'TAPAS', 'TATAR', 'TAZZA', 'VAGAL', 'VANDA', 'VARAS', 'VARNA', 'VASAL', 'WALLA', 'WATAP', 'ZANZA'] 
AAA: ['ABACA', 'ABAKA', 'AGAMA', 'ASANA'] 
AAI: ['ABACI', 'ACARI', 'AGAIN', 'AMAIN', 'ASSAI', 'AVAIL', 'AWAIT', 'LAARI', 'LANAI'] 
AAYA: ['ABAYA'] 
AE: ['ABBES', 'ABETS', 'ABLED', 'ABLER', 'ABLES', 'ACERB', 'ACHED', 'ACHES', 'ACMES', 'ACNED', 'ACNES', 'ACRED', 'ACRES', 'ACTED', 'ADDED', 'ADDER', 'ADDLE', 'ADEPT', 'ADMEN', 'ADZED', 'ADZES', 'AFTER', 'AGENT', 'AGERS', 'AGGER', 'AGLET', 'ALDER', 'ALECS', 'ALEFS', 'ALEPH', 'ALERT', 'ALMEH', 'ALMES', 'ALTER', 'AMBER', 'AMBLE', 'AMEND', 'AMENS', 'AMENT', 'AMPED', 'AMPLE', 'ANENT', 'ANGEL', 'ANGER', 'ANGLE', 'ANKLE', 'ANNEX', 'ANTED', 'ANTES', 'ANTRE', 'APERS', 'APPEL', 'APPLE', 'APRES', 'APSES', 'APTER', 'ARCED', 'ARDEB', 'ARGLE', 'ARLES', 'ARMED', 'ARMER', 'ARMET', 'ARPEN', 'ARSES', 'ARTEL', 'ASHED', 'ASHEN', 'ASHES', 'ASKED', 'ASKER', 'ASKEW', 'ASPEN', 'ASPER', 'ASSES', 'ASSET', 'ASTER', 'AVENS', 'AVERS', 'AVERT', 'AWNED', 'AXELS', 'AXLED', 'AXLES', 'AXMEN', 'BABEL', 'BABES', 'BADGE', 'BAGEL', 'BAKED', 'BAKER', 'BAKES', 'BALED', 'BALER', 'BALES', 'BANED', 'BANES', 'BARBE', 'BARDE', 'BARED', 'BARER', 'BARES', 'BARGE', 'BARRE', 'BASED', 'BASER', 'BASES', 'BASTE', 'BATED', 'BATES', 'BATHE', 'BLADE', 'BLAME', 'BLARE', 'BLASE', 'BLATE', 'BLAZE', 'BRACE', 'BRAES', 'BRAKE', 'BRAVE', 'BRAZE', 'CABER', 'CABLE', 'CACHE', 'CADES', 'CADET', 'CADGE', 'CADRE', 'CAFES', 'CAGED', 'CAGER', 'CAGES', 'CAKED', 'CAKES', 'CALVE', 'CAMEL', 'CAMES', 'CANED', 'CANER', 'CANES', 'CAPED', 'CAPER', 'CAPES', 'CARED', 'CARER', 'CARES', 'CARET', 'CAREX', 'CARLE', 'CARSE', 'CARTE', 'CARVE', 'CASED', 'CASES', 'CASTE', 'CATER', 'CATES', 'CAVED', 'CAVER', 'CAVES', 'CAWED', 'CHAFE', 'CHAPE', 'CHARE', 'CHASE', 'CLADE', 'CLAVE', 'CRAKE', 'CRANE', 'CRAPE', 'CRATE', 'CRAVE', 'CRAZE', 'DACES', 'DALES', 'DAMES', 'DANCE', 'DARED', 'DARER', 'DARES', 'DATED', 'DATER', 'DATES', 'DAVEN', 'DAWED', 'DAWEN', 'DAZED', 'DAZES', 'DRAKE', 'DRAPE', 'DRAVE', 'FABLE', 'FACED', 'FACER', 'FACES', 'FACET', 'FADED', 'FADER', 'FADES', 'FADGE', 'FAKED', 'FAKER', 'FAKES', 'FALSE', 'FAMED', 'FAMES', 'FANES', 'FARCE', 'FARED', 'FARER', 'FARES', 'FARLE', 'FATED', 'FATES', 'FAVES', 'FAXED', 'FAXES', 'FAZED', 'FAZES', 'FLAKE', 'FLAME', 'FLARE', 'FRAME', 'GABLE', 'GADJE', 'GAFFE', 'GAGED', 'GAGER', 'GAGES', 'GALES', 'GAMBE', 'GAMED', 'GAMER', 'GAMES', 'GANEF', 'GANEV', 'GAPED', 'GAPER', 'GAPES', 'GASES', 'GATED', 'GATER', 'GATES', 'GAVEL', 'GAZED', 'GAZER', 'GAZES', 'GLACE', 'GLADE', 'GLARE', 'GLAZE', 'GRACE', 'GRADE', 'GRAPE', 'GRATE', 'GRAVE', 'GRAZE', 'HACEK', 'HADED', 'HADES', 'HAEMS', 'HAETS', 'HAJES', 'HAKES', 'HALED', 'HALER', 'HALES', 'HALVE', 'HAMES', 'HANCE', 'HANSE', 'HARED', 'HAREM', 'HARES', 'HASTE', 'HATED', 'HATER', 'HATES', 'HAVEN', 'HAVER', 'HAVES', 'HAWED', 'HAWSE', 'HAZED', 'HAZEL', 'HAZER', 'HAZES', 'JADED', 'JADES', 'JAGER', 'JAKES', 'JAMBE', 'JANES', 'JAPED', 'JAPER', 'JAPES', 'JAWED', 'KALES', 'KAMES', 'KANES', 'KNAVE', 'KNAWE', 'LABEL', 'LACED', 'LACER', 'LACES', 'LADED', 'LADEN', 'LADER', 'LADES', 'LADLE', 'LAGER', 'LAKED', 'LAKER', 'LAKES', 'LAMED', 'LAMER', 'LAMES', 'LANCE', 'LANES', 'LAPEL', 'LAPSE', 'LARES', 'LARGE', 'LASED', 'LASER', 'LASES', 'LATED', 'LATEN', 'LATER', 'LATEX', 'LATHE', 'LATKE', 'LATTE', 'LAVED', 'LAVER', 'LAVES', 'LAWED', 'LAXER', 'LAXES', 'LAZED', 'LAZES', 'MABES', 'MACED', 'MACER', 'MACES', 'MACHE', 'MACLE', 'MADRE', 'MAGES', 'MAKER', 'MAKES', 'MALES', 'MANED', 'MANES', 'MANGE', 'MANSE', 'MAPLE', 'MARES', 'MARGE', 'MARSE', 'MASER', 'MASSE', 'MATED', 'MATER', 'MATES', 'MATTE', 'MAVEN', 'MAWED', 'MAXED', 'MAXES', 'MAZED', 'MAZER', 'MAZES', 'NABES', 'NACRE', 'NAKED', 'NALED', 'NAMED', 'NAMER', 'NAMES', 'NANCE', 'NAPES', 'NAPPE', 'NARES', 'NATES', 'NAVEL', 'NAVES', 'PACED', 'PACER', 'PACES', 'PADLE', 'PADRE', 'PAGED', 'PAGER', 'PAGES', 'PALED', 'PALER', 'PALES', 'PALET', 'PANED', 'PANEL', 'PANES', 'PANNE', 'PAPER', 'PARED', 'PARER', 'PARES', 'PARGE', 'PARLE', 'PARSE', 'PARVE', 'PASES', 'PASSE', 'PASTE', 'PATED', 'PATEN', 'PATER', 'PATES', 'PAVED', 'PAVER', 'PAVES', 'PAWED', 'PAWER', 'PAXES', 'PHAGE', 'PHASE', 'PLACE', 'PLAGE', 'PLANE', 'PLATE', 'PRASE', 'PRATE', 'RACED', 'RACER', 'RACES', 'RAGED', 'RAGES', 'RAJES', 'RAKED', 'RAKER', 'RAKES', 'RALES', 'RAMEN', 'RAMET', 'RANCE', 'RANGE', 'RAPED', 'RAPER', 'RAPES', 'RAPHE', 'RARED', 'RARER', 'RARES', 'RASED', 'RASER', 'RASES', 'RATED', 'RATEL', 'RATER', 'RATES', 'RATHE', 'RAVED', 'RAVEL', 'RAVEN', 'RAVER', 'RAVES', 'RAWER', 'RAXED', 'RAXES', 'RAZED', 'RAZER', 'RAZES', 'SABED', 'SABER', 'SABES', 'SABLE', 'SABRE', 'SADES', 'SADHE', 'SAFER', 'SAFES', 'SAGER', 'SAGES', 'SAKER', 'SAKES', 'SALEP', 'SALES', 'SALVE', 'SAMEK', 'SANED', 'SANER', 'SANES', 'SARGE', 'SATED', 'SATEM', 'SATES', 'SAVED', 'SAVER', 'SAVES', 'SAWED', 'SAWER', 'SAXES', 'SCALE', 'SCAPE', 'SCARE', 'SHADE', 'SHAKE', 'SHALE', 'SHAME', 'SHAPE', 'SHARE', 'SHAVE', 'SKATE', 'SLAKE', 'SLATE', 'SLAVE', 'SMAZE', 'SNAKE', 'SNARE', 'SPACE', 'SPADE', 'SPAED', 'SPAES', 'SPAKE', 'SPALE', 'SPARE', 'SPATE', 'STADE', 'STAGE', 'STAKE', 'STALE', 'STANE', 'STARE', 'STATE', 'STAVE', 'SWAGE', 'SWALE', 'SWARE', 'TABER', 'TABES', 'TABLE', 'TACES', 'TACET', 'TACHE', 'TAELS', 'TAJES', 'TAKEN', 'TAKER', 'TAKES', 'TALER', 'TALES', 'TAMED', 'TAMER', 'TAMES', 'TAPED', 'TAPER', 'TAPES', 'TARED', 'TARES', 'TARGE', 'TARRE', 'TASSE', 'TASTE', 'TATER', 'TATES', 'TAWED', 'TAWER', 'TAWSE', 'TAXED', 'TAXER', 'TAXES', 'TAZZE', 'THANE', 'TRACE', 'TRADE', 'TRAVE', 'TSADE', 'TWAES', 'VALES', 'VALET', 'VALSE', 'VALVE', 'VANED', 'VANES', 'VARVE', 'VASES', 'WACKE', 'WADED', 'WADER', 'WADES', 'WAFER', 'WAGED', 'WAGER', 'WAGES', 'WAKED', 'WAKEN', 'WAKER', 'WAKES', 'WALED', 'WALER', 'WALES', 'WAMES', 'WANED', 'WANES', 'WARED', 'WARES', 'WASTE', 'WATER', 'WAVED', 'WAVER', 'WAVES', 'WAXED', 'WAXEN', 'WAXER', 'WAXES', 'WHALE', 'ZAXES', 'ZAZEN'] 
AEY: ['ABBEY', 'AGLEY', 'ALLEY', 'APERY', 'CAGEY', 'CAKEY', 'FAERY', 'FAKEY', 'GAMEY', 'LACEY', 'MAMEY', 'MATEY', 'PACEY', 'WANEY', 'WAVEY'] 
AO: ['ABBOT', 'ABHOR', 'ABMHO', 'ABOHM', 'ABORT', 'ACOCK', 'ACOLD', 'ACORN', 'ACTOR', 'ADOPT', 'ADORN', 'ADOWN', 'AGGRO', 'AGLOW', 'AGONS', 'AHOLD', 'ALDOL', 'ALGOR', 'ALLOD', 'ALLOT', 'ALLOW', 'ALOFT', 'ALONG', 'ALTHO', 'ALTOS', 'AMBOS', 'AMMOS', 'AMOKS', 'AMONG', 'AMORT', 'ANCHO', 'ANCON', 'ANDRO', 'ANGLO', 'APODS', 'APORT', 'APRON', 'ARBOR', 'ARDOR', 'ARGOL', 'ARGON', 'ARGOT', 'ARMOR', 'ARROW', 'ARSON', 'ARVOS', 'ASCOT', 'ASKOS', 'ATOLL', 'ATOMS', 'AVOWS', 'AWOLS', 'AXONS', 'AZLON', 'AZONS', 'AZOTH', 'BACON', 'BANCO', 'BANJO', 'BARON', 'BASSO', 'BATON', 'BRAVO', 'CABOB', 'CAHOW', 'CAJON', 'CALOS', 'CAMOS', 'CAMPO', 'CANON', 'CANSO', 'CANTO', 'CAPON', 'CAPOS', 'CARBO', 'CARGO', 'CAROB', 'CAROL', 'CAROM', 'CHAOS', 'CLARO', 'DADOS', 'DAGOS', 'DATOS', 'DATTO', 'FADOS', 'FAGOT', 'FANON', 'FANOS', 'FAROS', 'FATSO', 'FAVOR', 'GADJO', 'GALOP', 'GANOF', 'GAOLS', 'GATOR', 'GAVOT', 'HALLO', 'HALON', 'HALOS', 'HAVOC', 'JABOT', 'JALOP', 'JATOS', 'KABOB', 'KAONS', 'KAPOK', 'LABOR', 'LARGO', 'LASSO', 'LLANO', 'MACHO', 'MACON', 'MACRO', 'MAGOT', 'MAJOR', 'MAKOS', 'MAMBO', 'MANGO', 'MANOR', 'MANOS', 'MASON', 'MATZO', 'NABOB', 'NACHO', 'NARCO', 'PAGOD', 'PANTO', 'PARGO', 'PAROL', 'PARVO', 'PRAOS', 'RACON', 'RADON', 'RATOS', 'RAZOR', 'SABOT', 'SAGOS', 'SALOL', 'SALON', 'SALVO', 'SAMBO', 'SANTO', 'SAPOR', 'SARGO', 'SAROD', 'SAROS', 'SAVOR', 'SHAKO', 'SPADO', 'TABOR', 'TACOS', 'TALON', 'TANGO', 'TANTO', 'TARDO', 'TAROC', 'TAROK', 'TAROS', 'TAROT', 'TAXOL', 'TAXON', 'VALOR', 'VAPOR', 'WACKO', 'WAGON', 'WHAMO'] 
AEA: ['ABEAM', 'ACETA', 'AHEAD', 'AKELA', 'AMEBA', 'ANEAR', 'APEAK', 'APNEA', 'AREAL', 'AREAS', 'ARECA', 'ARENA', 'AREPA', 'CAECA', 'FAENA', 'GALEA', 'PAEAN', 'PALEA'] 
AEE: ['ABELE', 'ACKEE', 'ADEEM', 'AEDES', 'AGENE', 'AGLEE', 'AGREE', 'AKEES', 'AKENE', 'ALLEE', 'AMEER', 'ANELE', 'APEEK', 'ARENE', 'ARETE', 'LAREE', 'RAGEE', 'RAKEE', 'RAMEE', 'RANEE', 'RAZEE', 'SAREE'] 
AIE: ['ABIDE', 'AFIRE', 'AGGIE', 'AGILE', 'AIDED', 'AIDER', 'AIDES', 'AILED', 'AIMED', 'AIMER', 'AIRED', 'AIRER', 'AISLE', 'AIVER', 'ALIEN', 'ALIKE', 'ALINE', 'ALIVE', 'ALKIE', 'AMICE', 'AMIDE', 'AMIES', 'AMINE', 'ANILE', 'ANIME', 'ANISE', 'ARIEL', 'ARISE', 'ASIDE', 'AXILE', 'AXITE', 'AZIDE', 'AZINE', 'BAIZE', 'CAVIE', 'MAILE', 'MAIZE', 'MAMIE', 'MAVIE', 'NAIVE', 'PAISE', 'RAISE', 'RAMIE', 'SAICE', 'TAWIE', 'WAIVE', 'ZAIRE'] 
AOE: ['ABODE', 'ABOVE', 'ADOBE', 'ADORE', 'ADOZE', 'AFORE', 'AGONE', 'ALOES', 'ALONE', 'AMOLE', 'ANODE', 'ANOLE', 'AROSE', 'ATONE', 'AWOKE', 'AXONE', 'AZOLE', 'AZOTE', 'CANOE', 'HAOLE', 'MAHOE'] 
AOI: ['ABOIL', 'ALOIN', 'AROID', 'ASKOI', 'AVOID', 'AZOIC'] 
AOA: ['ABOMA', 'AGORA', 'ALOHA', 'ANOAS', 'AORTA', 'AROMA'] 
AOO: ['ABOON', 'ACHOO', 'ADOBO', 'AFOOT', 'ALOOF', 'BABOO', 'BAZOO', 'GAZOO', 'KAROO', 'KAZOO', 'TABOO', 'WAHOO', 'WAZOO'] 
AOU: ['ABOUT', 'AFOUL', 'ALOUD', 'AMOUR', 'SAJOU'] 
AI: ['ABRIS', 'ACIDS', 'ACING', 'ACMIC', 'ACRID', 'ACTIN', 'ADITS', 'ADMIT', 'ADMIX', 'AFFIX', 'AFRIT', 'AGING', 'AGISM', 'AGIST', 'AHING', 'AIRNS', 'AIRTH', 'AIRTS', 'AITCH', 'ALCID', 'ALGID', 'ALGIN', 'ALIFS', 'ALIGN', 'ALIST', 'AMBIT', 'AMIDS', 'AMINS', 'AMIRS', 'AMISS', 'AMNIC', 'ANILS', 'ANTIC', 'ANTIS', 'ANVIL', 'APHID', 'APHIS', 'APING', 'APISH', 'APSIS', 'ARGIL', 'ARILS', 'ARRIS', 'ARSIS', 'ASDIC', 'ASPIC', 'ASPIS', 'ASTIR', 'ATILT', 'ATRIP', 'ATTIC', 'AWING', 'AXILS', 'AXING', 'BAILS', 'BAIRN', 'BAITH', 'BAITS', 'BARIC', 'BASIC', 'BASIL', 'BASIN', 'BASIS', 'BASSI', 'BATIK', 'BLAIN', 'BRAID', 'BRAIL', 'BRAIN', 'BRAVI', 'CABIN', 'CACTI', 'CADIS', 'CAIDS', 'CAINS', 'CAIRD', 'CAIRN', 'CALIF', 'CALIX', 'CAMPI', 'CANID', 'CAPIZ', 'CARPI', 'CAVIL', 'CHAIN', 'CHAIR', 'CHAIS', 'CLAIM', 'CLAVI', 'DARIC', 'DASHI', 'DAVIT', 'DRAIL', 'DRAIN', 'FAGIN', 'FAILS', 'FAINT', 'FAIRS', 'FAITH', 'FAKIR', 'FAQIR', 'FARCI', 'FLAIL', 'FLAIR', 'FRAIL', 'GADDI', 'GADID', 'GADIS', 'GAINS', 'GAITS', 'GAMIC', 'GAMIN', 'GARNI', 'GHAZI', 'GLAIR', 'GRAIL', 'GRAIN', 'HABIT', 'HADJI', 'HAFIZ', 'HAIKS', 'HAILS', 'HAINT', 'HAIRS', 'HAJIS', 'HAJJI', 'HAKIM', 'HALID', 'JAILS', 'KADIS', 'KAFIR', 'KAIFS', 'KAILS', 'KAINS', 'KAKIS', 'KALIF', 'KAMIK', 'KANJI', 'KHADI', 'KHAKI', 'KRAIT', 'LAICH', 'LAICS', 'LAIGH', 'LAIRD', 'LAIRS', 'LAITH', 'LAPIN', 'LAPIS', 'LARIS', 'LASSI', 'LATHI', 'MAFIC', 'MAGIC', 'MAIDS', 'MAILL', 'MAILS', 'MAIMS', 'MAINS', 'MAIRS', 'MAIST', 'MALIC', 'MANIC', 'MATIN', 'MAVIN', 'MAVIS', 'MAXIM', 'MAXIS', 'NABIS', 'NADIR', 'NAIFS', 'NAILS', 'NARIC', 'NARIS', 'NAZIS', 'PADIS', 'PADRI', 'PAIKS', 'PAILS', 'PAINS', 'PAINT', 'PAIRS', 'PALPI', 'PANIC', 'PAPPI', 'PARDI', 'PARIS', 'PATIN', 'PAVID', 'PAVIN', 'PAVIS', 'PLAID', 'PLAIN', 'PLAIT', 'QADIS', 'QAIDS', 'RABBI', 'RABIC', 'RABID', 'RADIX', 'RAGIS', 'RAIDS', 'RAILS', 'RAINS', 'RAKIS', 'RANID', 'RANIS', 'RAPID', 'RAVIN', 'RAWIN', 'SABIN', 'SABIR', 'SADIS', 'SAHIB', 'SAIDS', 'SAILS', 'SAINS', 'SAINT', 'SAITH', 'SAKIS', 'SALIC', 'SALMI', 'SAPID', 'SARIN', 'SARIS', 'SASIN', 'SATIN', 'SATIS', 'SAVIN', 'SLAIN', 'SNAIL', 'SPAHI', 'SPAIL', 'SPAIT', 'STAID', 'STAIG', 'STAIN', 'STAIR', 'SWAIL', 'SWAIN', 'SWAMI', 'TABID', 'TACIT', 'TAILS', 'TAINS', 'TAINT', 'TAKIN', 'TAMIS', 'TAPIR', 'TAPIS', 'TARSI', 'TAXIS', 'TRAGI', 'TRAIK', 'TRAIL', 'TRAIN', 'TRAIT', 'TSADI', 'TWAIN', 'VAILS', 'VAIRS', 'VAKIL', 'VALID', 'VAPID', 'VARIX', 'VATIC', 'WADIS', 'WAIFS', 'WAILS', 'WAINS', 'WAIRS', 'WAIST', 'WAITS'] 
AUE: ['ABUSE', 'ACUTE', 'AGUES', 'AMUSE', 'ARGUE', 'AUGER', 'AURES', 'AZURE', 'CAUSE', 'DAUBE', 'FAUVE', 'GAUGE', 'GAUZE', 'HAUTE', 'MAUVE', 'PAUSE', 'SAUCE', 'SAUTE', 'TAUPE', 'VAGUE', 'VALUE'] 
AU: ['ABUTS', 'ABUZZ', 'ADULT', 'ADUNC', 'ADUST', 'AHULL', 'ALBUM', 'ALGUM', 'ALMUD', 'ALMUG', 'ALUMS', 'AMPUL', 'AMUCK', 'ANKUS', 'ANNUL', 'ARCUS', 'ARGUS', 'ARUMS', 'ASCUS', 'AUGHT', 'AUNTS', 'AWFUL', 'BABUL', 'BABUS', 'BATTU', 'BAUDS', 'BAULK', 'CAPUT', 'CASUS', 'CAULD', 'CAULK', 'CAULS', 'DATUM', 'DAUBS', 'DAUNT', 'DAUTS', 'FANUM', 'FAUGH', 'FAULD', 'FAULT', 'FAUNS', 'FAVUS', 'FRAUD', 'GAMUT', 'GAUDS', 'GAULT', 'GAUMS', 'GAUNT', 'GAURS', 'GAUSS', 'GHAUT', 'HABUS', 'HAKUS', 'HAUGH', 'HAULM', 'HAULS', 'HAUNT', 'JAUKS', 'JAUNT', 'JAUPS', 'KAGUS', 'KANZU', 'KAPUT', 'KNAUR', 'KRAUT', 'LARUM', 'LAUDS', 'LAUGH', 'MAGUS', 'MANUS', 'MAUDS', 'MAULS', 'MAUND', 'MAUTS', 'PRAHU', 'PRAUS', 'RAKUS', 'RAMUS', 'SADHU', 'SAGUM', 'SAUCH', 'SAUGH', 'SAULS', 'SAULT', 'SCAUP', 'SCAUR', 'SHAUL', 'SNAFU', 'TABUN', 'TABUS', 'TALUK', 'TALUS', 'TAUNT', 'TAUTS', 'TAXUS', 'VAGUS', 'VARUS', 'VATUS', 'VAULT', 'VAUNT', 'WAMUS', 'WAUGH', 'WAUKS', 'WAULS', 'WHAUP'] 
AYE: ['ABYES', 'BARYE', 'BAYED', 'FAYED', 'GAYER', 'HAYED', 'HAYER', 'LAYED', 'LAYER', 'MAYBE', 'MAYED', 'PAYED', 'PAYER', 'RAYED', 'SAYED', 'SAYER'] 
AY: ['ABYSM', 'ABYSS', 'ACYLS', 'ALKYD', 'ALKYL', 'ALLYL', 'AMBRY', 'AMPLY', 'AMYLS', 'ANGRY', 'ANTSY', 'APPLY', 'APTLY', 'ARTSY', 'ARYLS', 'BADDY', 'BADLY', 'BAFFY', 'BAGGY', 'BALDY', 'BALKY', 'BALLY', 'BALMY', 'BANDY', 'BANTY', 'BARKY', 'BARMY', 'BARNY', 'BASSY', 'BATTY', 'BAWDY', 'BAWTY', 'BRAKY', 'BRAXY', 'BRAYS', 'CABBY', 'CADDY', 'CADGY', 'CALYX', 'CAMPY', 'CANDY', 'CANNY', 'CANTY', 'CARNY', 'CARRY', 'CASKY', 'CATTY', 'CHARY', 'CHAYS', 'CLARY', 'CLAYS', 'CRAZY', 'DADDY', 'DAFFY', 'DALLY', 'DANDY', 'DARKY', 'DASHY', 'DRAYS', 'FADDY', 'FAGGY', 'FANCY', 'FANNY', 'FARCY', 'FATLY', 'FATTY', 'FAWNY', 'FLAKY', 'FLAMY', 'FLAWY', 'FLAXY', 'FLAYS', 'FRAYS', 'GABBY', 'GALLY', 'GAMMY', 'GAPPY', 'GASSY', 'GAWKY', 'GAWSY', 'GLADY', 'GLARY', 'GLAZY', 'GRAPY', 'GRAVY', 'GRAYS', 'HAMMY', 'HANDY', 'HANKY', 'HAPLY', 'HAPPY', 'HARDY', 'HARPY', 'HARRY', 'HASTY', 'JACKY', 'JAGGY', 'JAMMY', 'JANTY', 'JAZZY', 'LAMBY', 'LANKY', 'LARDY', 'LARKY', 'LATHY', 'LAWNY', 'LAXLY', 'MADLY', 'MALMY', 'MALTY', 'MAMMY', 'MANGY', 'MANLY', 'MARLY', 'MARRY', 'MARVY', 'MASHY', 'MASSY', 'MAYST', 'NAGGY', 'NANCY', 'NANNY', 'NAPPY', 'NARKY', 'NASTY', 'NATTY', 'NAVVY', 'PADDY', 'PALLY', 'PALMY', 'PALSY', 'PANDY', 'PANSY', 'PANTY', 'PAPPY', 'PARDY', 'PARRY', 'PARTY', 'PASTY', 'PATLY', 'PATSY', 'PATTY', 'PAWKY', 'PLATY', 'PLAYS', 'PRAYS', 'RAGGY', 'RALLY', 'RAMMY', 'RANDY', 'RANGY', 'RASPY', 'RATTY', 'RAWLY', 'SADLY', 'SAGGY', 'SALLY', 'SALTY', 'SANDY', 'SAPPY', 'SARKY', 'SASSY', 'SATYR', 'SAVVY', 'SAYST', 'SCALY', 'SCARY', 'SHADY', 'SHAKY', 'SHALY', 'SHAYS', 'SLATY', 'SLAYS', 'SNAKY', 'SPACY', 'SPAYS', 'SPLAY', 'SPRAY', 'STAGY', 'STAYS', 'STRAY', 'SWAMY', 'SWAYS', 'TABBY', 'TACKY', 'TAFFY', 'TALKY', 'TALLY', 'TAMMY', 'TANGY', 'TANSY', 'TARDY', 'TARRY', 'TARTY', 'TASTY', 'TATTY', 'TAWNY', 'TRAYS', 'VAMPY', 'VASTY', 'WACKY', 'WADDY', 'WALLY', 'WANLY', 'WARTY', 'WASHY', 'WASPY', 'ZAPPY'] 
AIY: ['ACIDY', 'AMITY', 'DAILY', 'DAIRY', 'DAISY', 'FAIRY', 'GAILY', 'HAIRY', 'LAITY', 'RAINY'] 
AII: ['ACINI', 'ALIBI', 'AMICI', 'ANIMI', 'RADII'] 
AIEU: ['ADIEU'] 
AIO: ['ADIOS', 'AGIOS', 'AMIDO', 'AMIGO', 'AMINO', 'AMNIO', 'ANION', 'AVION', 'AVISO', 'AXIOM', 'AXION', 'AZIDO', 'DANIO', 'PATIO', 'RADIO', 'RATIO'] 
AYA: ['ADYTA', 'ASYLA', 'AYAHS', 'GAYAL', 'KAYAK', 'MAYAN', 'MAYAS', 'PLAYA', 'RAYAH', 'RAYAS'] 
AEIA: ['AECIA'] 
AEI: ['AEGIS', 'AREIC', 'NAEVI'] 
AEO: ['AEONS', 'CAMEO', 'LAEVO', 'PAEON', 'PAREO', 'PASEO'] 
AEIE: ['AERIE'] 
AIA: ['AGITA', 'AGRIA', 'AJIVA', 'ALIAS', 'AMIAS', 'AMIGA', 'AMNIA', 'ANIMA', 'APIAN', 'ARIAS', 'ATRIA', 'AVIAN', 'AXIAL', 'BAIZA', 'FACIA', 'HAIKA', 'KAIAK', 'LABIA', 'LAMIA', 'MAFIA', 'MANIA', 'MARIA', 'NAIAD', 'NAIRA', 'PAISA', 'RAIAS', 'RAITA', 'SAIGA', 'TAFIA', 'TAIGA', 'VARIA', 'ZAMIA'] 
AOY: ['AGONY', 'ALLOY', 'ANNOY', 'ANOMY', 'ATOMY', 'ATONY', 'ATOPY', 'SAVOY'] 
AIOI: ['AIOLI'] 
AUA: ['AJUGA', 'ALULA', 'AQUAS', 'AUDAD', 'AURAL', 'AURAR', 'AURAS', 'FAUNA', 'LAUAN', 'LAURA', 'SAUNA', 'VACUA'] 
AAO: ['ALAMO', 'CACAO'] 
AAY: ['ALARY', 'ALLAY', 'ALWAY', 'ARRAY', 'ASSAY', 'ATAXY', 'GAMAY', 'SATAY'] 
AIYA: ['ALIYA'] 
A: ['ANGST', 'ANKHS', 'BACKS', 'BAFFS', 'BAHTS', 'BALDS', 'BALKS', 'BALLS', 'BALMS', 'BANDS', 'BANGS', 'BANKS', 'BANNS', 'BARBS', 'BARDS', 'BARFS', 'BARKS', 'BARMS', 'BARNS', 'BASKS', 'BASTS', 'BATCH', 'BATHS', 'BATTS', 'BAWDS', 'BAWLS', 'BHANG', 'BLABS', 'BLACK', 'BLAFF', 'BLAHS', 'BLAMS', 'BLAND', 'BLANK', 'BLAST', 'BLATS', 'BLAWN', 'BLAWS', 'BRACH', 'BRACT', 'BRADS', 'BRAGS', 'BRAND', 'BRANK', 'BRANS', 'BRANT', 'BRASH', 'BRASS', 'BRATS', 'BRAWL', 'BRAWN', 'BRAWS', 'CAFFS', 'CALFS', 'CALKS', 'CALLS', 'CALMS', 'CAMPS', 'CANST', 'CANTS', 'CAPHS', 'CARBS', 'CARDS', 'CARKS', 'CARLS', 'CARNS', 'CARPS', 'CARRS', 'CARTS', 'CASKS', 'CASTS', 'CATCH', 'CHADS', 'CHAFF', 'CHALK', 'CHAMP', 'CHAMS', 'CHANG', 'CHANT', 'CHAPS', 'CHAPT', 'CHARD', 'CHARK', 'CHARM', 'CHARR', 'CHARS', 'CHART', 'CHASM', 'CHATS', 'CHAWS', 'CLACH', 'CLACK', 'CLADS', 'CLAGS', 'CLAMP', 'CLAMS', 'CLANG', 'CLANK', 'CLANS', 'CLAPS', 'CLAPT', 'CLASH', 'CLASP', 'CLASS', 'CLAST', 'CLAWS', 'CRABS', 'CRACK', 'CRAFT', 'CRAGS', 'CRAMP', 'CRAMS', 'CRANK', 'CRAPS', 'CRASH', 'CRASS', 'CRAWL', 'CRAWS', 'CZARS', 'DAFFS', 'DAHLS', 'DAMNS', 'DAMPS', 'DANGS', 'DARBS', 'DARKS', 'DARNS', 'DARTS', 'DAWKS', 'DAWNS', 'DAWTS', 'DHAKS', 'DHALS', 'DRABS', 'DRAFF', 'DRAFT', 'DRAGS', 'DRAMS', 'DRANK', 'DRATS', 'DRAWL', 'DRAWN', 'DRAWS', 'DWARF', 'FACTS', 'FALLS', 'FANGS', 'FARDS', 'FARLS', 'FARMS', 'FARTS', 'FASTS', 'FAWNS', 'FLABS', 'FLACK', 'FLAGS', 'FLAMS', 'FLANK', 'FLANS', 'FLAPS', 'FLASH', 'FLASK', 'FLATS', 'FLAWS', 'FRAGS', 'FRANC', 'FRANK', 'FRAPS', 'FRASS', 'FRATS', 'GAFFS', 'GALLS', 'GAMBS', 'GAMPS', 'GANGS', 'GARBS', 'GARTH', 'GASPS', 'GASTS', 'GAWKS', 'GAWPS', 'GHAST', 'GHATS', 'GLADS', 'GLAMS', 'GLAND', 'GLANS', 'GLASS', 'GNARL', 'GNARR', 'GNARS', 'GNASH', 'GNATS', 'GNAWN', 'GNAWS', 'GRABS', 'GRADS', 'GRAFT', 'GRAMP', 'GRAMS', 'GRAND', 'GRANS', 'GRANT', 'GRAPH', 'GRASP', 'GRASS', 'HACKS', 'HADST', 'HAFTS', 'HALLS', 'HALMS', 'HALTS', 'HANDS', 'HANGS', 'HANKS', 'HANTS', 'HARDS', 'HARKS', 'HARLS', 'HARMS', 'HARPS', 'HARSH', 'HARTS', 'HASPS', 'HATCH', 'HAWKS', 'JACKS', 'JAGGS', 'JAMBS', 'JARLS', 'KAPHS', 'KARNS', 'KARST', 'KARTS', 'KBARS', 'KHAFS', 'KHANS', 'KHAPH', 'KHATS', 'KNACK', 'KNAPS', 'KNARS', 'KRAFT', 'KVASS', 'LACKS', 'LAKHS', 'LALLS', 'LAMBS', 'LAMPS', 'LANDS', 'LARCH', 'LARDS', 'LARKS', 'LASTS', 'LATCH', 'LATHS', 'LAWNS', 'MACHS', 'MACKS', 'MALLS', 'MALMS', 'MALTS', 'MARCH', 'MARCS', 'MARKS', 'MARLS', 'MARSH', 'MARTS', 'MASKS', 'MASTS', 'MATCH', 'MATHS', 'MATTS', 'NAFFS', 'NARCS', 'NARDS', 'NARKS', 'NATCH', 'PACKS', 'PACTS', 'PALLS', 'PALMS', 'PALPS', 'PANGS', 'PANTS', 'PARCH', 'PARDS', 'PARKS', 'PARRS', 'PARTS', 'PASTS', 'PATCH', 'PATHS', 'PAWLS', 'PAWNS', 'PLACK', 'PLANK', 'PLANS', 'PLANT', 'PLASH', 'PLASM', 'PLATS', 'PRAMS', 'PRANG', 'PRANK', 'PRATS', 'PRAWN', 'PSALM', 'PSHAW', 'RACKS', 'RAFFS', 'RAFTS', 'RAGGS', 'RALPH', 'RAMPS', 'RANCH', 'RANDS', 'RANKS', 'RANTS', 'RASPS', 'RATCH', 'SACKS', 'SALPS', 'SALTS', 'SAMPS', 'SANDS', 'SANGH', 'SARDS', 'SARKS', 'SCABS', 'SCADS', 'SCAGS', 'SCALD', 'SCALL', 'SCALP', 'SCAMP', 'SCAMS', 'SCANS', 'SCANT', 'SCARF', 'SCARP', 'SCARS', 'SCART', 'SCATS', 'SCATT', 'SCHAV', 'SCHWA', 'SCRAG', 'SCRAM', 'SCRAP', 'SHACK', 'SHADS', 'SHAFT', 'SHAGS', 'SHAHS', 'SHALL', 'SHALT', 'SHAMS', 'SHANK', 'SHARD', 'SHARK', 'SHARN', 'SHARP', 'SHAWL', 'SHAWM', 'SHAWN', 'SHAWS', 'SHWAS', 'SKAGS', 'SKALD', 'SKANK', 'SKATS', 'SLABS', 'SLACK', 'SLAGS', 'SLAMS', 'SLANG', 'SLANK', 'SLANT', 'SLAPS', 'SLASH', 'SLATS', 'SLAWS', 'SMACK', 'SMALL', 'SMALT', 'SMARM', 'SMART', 'SMASH', 'SNACK', 'SNAGS', 'SNAPS', 'SNARF', 'SNARK', 'SNARL', 'SNASH', 'SNATH', 'SNAWS', 'SPALL', 'SPAMS', 'SPANG', 'SPANK', 'SPANS', 'SPARK', 'SPARS', 'SPASM', 'SPATS', 'SPAWN', 'SPAZZ', 'SPLAT', 'SPRAG', 'SPRAT', 'STABS', 'STACK', 'STAFF', 'STAGS', 'STALK', 'STALL', 'STAMP', 'STAND', 'STANG', 'STANK', 'STAPH', 'STARK', 'STARS', 'START', 'STASH', 'STATS', 'STRAP', 'STRAW', 'SWABS', 'SWAGS', 'SWAMP', 'SWANG', 'SWANK', 'SWANS', 'SWAPS', 'SWARD', 'SWARF', 'SWARM', 'SWART', 'SWASH', 'SWATH', 'SWATS', 'TACHS', 'TACKS', 'TACTS', 'TAHRS', 'TALCS', 'TALKS', 'TALLS', 'TAMPS', 'TANGS', 'TANKS', 'TARNS', 'TARPS', 'TARTS', 'TASKS', 'THACK', 'THANK', 'THARM', 'THAWS', 'THRAW', 'TRACK', 'TRACT', 'TRAMP', 'TRAMS', 'TRANK', 'TRANQ', 'TRANS', 'TRAPS', 'TRAPT', 'TRASH', 'TRASS', 'TRAWL', 'TSARS', 'TWANG', 'TWATS', 'TZARS', 'VAMPS', 'VANGS', 'VASTS', 'WACKS', 'WAFFS', 'WAFTS', 'WALKS', 'WALLS', 'WALTZ', 'WANDS', 'WANKS', 'WANTS', 'WARDS', 'WARKS', 'WARMS', 'WARNS', 'WARPS', 'WARTS', 'WASPS', 'WASTS', 'WATCH', 'WATTS', 'WAWLS', 'WHACK', 'WHAMS', 'WHANG', 'WHAPS', 'WHARF', 'WHATS', 'WRACK', 'WRANG', 'WRAPS', 'WRAPT', 'WRATH', 'ZARFS'] 
AYO: ['ANYON', 'KAYOS', 'MAYOR', 'MAYOS', 'PAYOR', 'RAYON'] 
AUAE: ['AQUAE', 'AURAE'] 
AEAE: ['AREAE'] 
AUIO: ['AUDIO'] 
AUI: ['AUDIT', 'AULIC', 'AURIC', 'AURIS', 'AUXIN', 'AZUKI', 'KAURI', 'MAQUI'] 
AUU: ['AUGUR', 'AURUM'] 
AUY: ['AUNTY', 'DAUBY', 'GAUDY', 'GAUZY', 'KAURY', 'SAUCY', 'SAURY'] 
AUEI: ['AUREI'] 
AUO: ['AUTOS', 'TAUON'] 
AYI: ['AYINS', 'LAYIN', 'SAYID', 'ZAYIN'] 
AYOU: ['BAYOU'] 
EA: ['BEACH', 'BEADS', 'BEAKS', 'BEAMS', 'BEANS', 'BEARD', 'BEARS', 'BEAST', 'BEATS', 'BECAP', 'BEGAN', 'BEGAT', 'BELGA', 'BEMAS', 'BETAS', 'BETTA', 'BLEAK', 'BLEAR', 'BLEAT', 'BREAD', 'BREAK', 'BREAM', 'CECAL', 'CEDAR', 'CELLA', 'CESTA', 'CHEAP', 'CHEAT', 'CHELA', 'CLEAN', 'CLEAR', 'CLEAT', 'CREAK', 'CREAM', 'DEADS', 'DEALS', 'DEALT', 'DEANS', 'DEARS', 'DEASH', 'DEATH', 'DEBAG', 'DEBAR', 'DECAF', 'DECAL', 'DEDAL', 'DEFAT', 'DEGAS', 'DELTA', 'DENAR', 'DERAT', 'DERMA', 'DEVAS', 'DEWAN', 'DEWAR', 'DEWAX', 'DREAD', 'DREAM', 'DREAR', 'EARLS', 'EARNS', 'EARTH', 'EASTS', 'ECLAT', 'EGADS', 'EGGAR', 'ELAND', 'ELANS', 'EMBAR', 'ENACT', 'EPACT', 'EPHAH', 'EPHAS', 'ESCAR', 'ESKAR', 'ETNAS', 'EXACT', 'EXALT', 'EXAMS', 'EXPAT', 'EXTRA', 'FEARS', 'FEAST', 'FEATS', 'FECAL', 'FELLA', 'FERAL', 'FETAL', 'FETAS', 'FLEAM', 'FLEAS', 'FREAK', 'FRENA', 'GEARS', 'GEMMA', 'GERAH', 'GETAS', 'GLEAM', 'GLEAN', 'GLEBA', 'GREAT', 'HEADS', 'HEALS', 'HEAPS', 'HEARD', 'HEARS', 'HEART', 'HEATH', 'HEATS', 'HEMAL', 'HENNA', 'HERMA', 'HEXAD', 'JEANS', 'JEHAD', 'KEBAB', 'KEBAR', 'KENAF', 'KHEDA', 'KNEAD', 'LEACH', 'LEADS', 'LEAFS', 'LEAKS', 'LEANS', 'LEANT', 'LEAPS', 'LEAPT', 'LEARN', 'LEARS', 'LEASH', 'LEAST', 'LEGAL', 'LEMAN', 'LEMMA', 'LEPTA', 'MEADS', 'MEALS', 'MEANS', 'MEANT', 'MEATS', 'MECCA', 'MEDAL', 'MENAD', 'MENSA', 'MENTA', 'MESAS', 'METAL', 'NEAPS', 'NEARS', 'NEATH', 'NEATS', 'NEMAS', 'PEACH', 'PEAGS', 'PEAKS', 'PEALS', 'PEANS', 'PEARL', 'PEARS', 'PEART', 'PEATS', 'PECAN', 'PEDAL', 'PEKAN', 'PENAL', 'PENNA', 'PEPLA', 'PETAL', 'PLEAD', 'PLEAS', 'PLEAT', 'PLENA', 'PRESA', 'REACH', 'REACT', 'READD', 'READS', 'REALM', 'REALS', 'REAMS', 'REAPS', 'REARM', 'REARS', 'REBAR', 'RECAP', 'RECTA', 'REDAN', 'REGAL', 'REGMA', 'REGNA', 'REHAB', 'RELAX', 'REMAN', 'REMAP', 'RENAL', 'RERAN', 'RESAT', 'RESAW', 'RETAG', 'RETAX', 'REWAN', 'REWAX', 'RHEAS', 'SCENA', 'SEALS', 'SEAMS', 'SEARS', 'SEATS', 'SEDAN', 'SELAH', 'SELVA', 'SENNA', 'SENSA', 'SEPAL', 'SEPTA', 'SERAC', 'SERAL', 'SETAL', 'SEWAN', 'SEWAR', 'SHEAF', 'SHEAL', 'SHEAR', 'SHEAS', 'SKEAN', 'SMEAR', 'SNEAK', 'SNEAP', 'SPEAK', 'SPEAN', 'SPEAR', 'STEAD', 'STEAK', 'STEAL', 'STEAM', 'STELA', 'SWEAR', 'SWEAT', 'TEACH', 'TEAKS', 'TEALS', 'TEAMS', 'TEARS', 'TEATS', 'TECTA', 'TEPAL', 'TEPAS', 'TERGA', 'TERRA', 'TESLA', 'TESTA', 'TETRA', 'TEXAS', 'THECA', 'THETA', 'TREAD', 'TREAT', 'TWEAK', 'VEALS', 'VEGAN', 'VELAR', 'VENAL', 'VESTA', 'WEALD', 'WEALS', 'WEANS', 'WEARS', 'WEKAS', 'WHEAL', 'WHEAT', 'WREAK', 'ZEALS', 'ZEBRA', 'ZETAS'] 
EAY: ['BEADY', 'BEAKY', 'BEAMY', 'BELAY', 'DEARY', 'DECAY', 'DELAY', 'DERAY', 'EARLY', 'EMBAY', 'ESSAY', 'HEADY', 'HEAPY', 'HEAVY', 'LEADY', 'LEAFY', 'LEAKY', 'LEARY', 'LEAVY', 'MEALY', 'MEANY', 'MEATY', 'PEAKY', 'PEATY', 'PEAVY', 'READY', 'RELAY', 'REPAY', 'RESAY', 'SEAMY', 'TEARY', 'VEALY', 'WEARY'] 
EAO: ['BEANO'] 
EAU: ['BEAUS', 'BEAUT', 'BEAUX'] 
EO: ['BEBOP', 'BEFOG', 'BEGOT', 'BELON', 'BELOW', 'BENTO', 'BESOM', 'BESOT', 'BETON', 'BEVOR', 'CELLO', 'CELOM', 'CENTO', 'CEORL', 'CEROS', 'CHEMO', 'CREDO', 'DECOR', 'DECOS', 'DEFOG', 'DEKKO', 'DEMOB', 'DEMON', 'DEMOS', 'DEPOT', 'DETOX', 'DEVON', 'EBONS', 'ECHOS', 'ELBOW', 'EMBOW', 'ENDOW', 'ENOLS', 'ENORM', 'ENOWS', 'ENROL', 'EPHOD', 'EPHOR', 'EPOCH', 'ERGOT', 'ERROR', 'ESCOT', 'ESTOP', 'ETHOS', 'EXONS', 'EXPOS', 'EXTOL', 'FELON', 'FEODS', 'FEOFF', 'FETOR', 'GECKO', 'GEMOT', 'GENOM', 'GENRO', 'GESSO', 'GREGO', 'HELLO', 'HELOS', 'HELOT', 'HERON', 'HEROS', 'JELLO', 'JETON', 'KEBOB', 'KENDO', 'KENOS', 'KETOL', 'LEMON', 'LENOS', 'LENTO', 'LESBO', 'MELON', 'MEMOS', 'MEOWS', 'MESON', 'METOL', 'METRO', 'MEZZO', 'NEONS', 'NEROL', 'NETOP', 'PEDRO', 'PELON', 'PENGO', 'PEONS', 'PEPOS', 'PESOS', 'PESTO', 'PETTO', 'PLEON', 'PREOP', 'REBOP', 'RECON', 'RECTO', 'REDON', 'REDOS', 'REDOX', 'REPOS', 'REPOT', 'REPRO', 'RESOD', 'RESOW', 'RETRO', 'REWON', 'SECCO', 'SEGNO', 'SEGOS', 'SENOR', 'SEROW', 'SERVO', 'SETON', 'SEXTO', 'SHEOL', 'STENO', 'TELCO', 'TELOS', 'TEMPO', 'TENON', 'TENOR', 'VENOM', 'VERSO', 'XENON', 'XEROX', 'ZEROS'] 
E: ['BECKS', 'BELCH', 'BELLS', 'BELTS', 'BENCH', 'BENDS', 'BENTS', 'BERGS', 'BERKS', 'BERMS', 'BERTH', 'BESTS', 'BETHS', 'BLEBS', 'BLEND', 'BLENT', 'BLESS', 'BLEST', 'BLETS', 'BRENS', 'BRENT', 'BREWS', 'CELLS', 'CELTS', 'CENTS', 'CHECK', 'CHEFS', 'CHERT', 'CHESS', 'CHEST', 'CHETH', 'CHEWS', 'CLEFS', 'CLEFT', 'CLEPT', 'CLERK', 'CLEWS', 'CREDS', 'CREPT', 'CRESS', 'CREST', 'CREWS', 'DEBTS', 'DECKS', 'DELFS', 'DELFT', 'DELLS', 'DELTS', 'DENTS', 'DEPTH', 'DERMS', 'DESKS', 'DRECK', 'DREGS', 'DREKS', 'DRESS', 'DREST', 'DWELL', 'DWELT', 'FECKS', 'FELLS', 'FELTS', 'FENDS', 'FERNS', 'FESTS', 'FETCH', 'FJELD', 'FLECK', 'FLESH', 'FLEWS', 'FREMD', 'FRESH', 'FRETS', 'GECKS', 'GELDS', 'GELTS', 'GENTS', 'GERMS', 'GESTS', 'GLEDS', 'GLENS', 'HECKS', 'HEFTS', 'HELLS', 'HELMS', 'HELPS', 'HEMPS', 'HENTS', 'HERBS', 'HERDS', 'HERLS', 'HERMS', 'HERNS', 'HERTZ', 'HESTS', 'HETHS', 'JELLS', 'JERKS', 'JESTS', 'KECKS', 'KELPS', 'KELTS', 'KEMPS', 'KEMPT', 'KENCH', 'KERBS', 'KERFS', 'KERNS', 'KETCH', 'KHETH', 'KHETS', 'KNELL', 'KNELT', 'KVELL', 'LEFTS', 'LEHRS', 'LENDS', 'LETCH', 'MELDS', 'MELLS', 'MELTS', 'MENDS', 'MENSH', 'MERCH', 'MERCS', 'MERKS', 'MERLS', 'METHS', 'MEWLS', 'NECKS', 'NERDS', 'NERTS', 'NERTZ', 'NESTS', 'NETTS', 'NEWTS', 'PECHS', 'PECKS', 'PELFS', 'PELTS', 'PENDS', 'PERCH', 'PERKS', 'PERMS', 'PERPS', 'PERVS', 'PESTS', 'PLEBS', 'PLEWS', 'PREPS', 'PRESS', 'PREST', 'RECKS', 'REDDS', 'RENDS', 'RENTS', 'REPPS', 'RESTS', 'RETCH', 'SCEND', 'SCENT', 'SCREW', 'SECTS', 'SELFS', 'SELLS', 'SENDS', 'SEPTS', 'SERFS', 'SETTS', 'SEXTS', 'SHEDS', 'SHELF', 'SHELL', 'SHEND', 'SHENT', 'SHERD', 'SHEWN', 'SHEWS', 'SHLEP', 'SHRED', 'SHREW', 'SKEGS', 'SKELL', 'SKELM', 'SKELP', 'SKEPS', 'SKEWS', 'SLEDS', 'SLEPT', 'SLEWS', 'SMELL', 'SMELT', 'SMERK', 'SMEWS', 'SNECK', 'SNEDS', 'SNELL', 'SPECK', 'SPECS', 'SPELL', 'SPELT', 'SPEND', 'SPENT', 'SPERM', 'SPEWS', 'STEMS', 'STENT', 'STEPS', 'STERN', 'STETS', 'STEWS', 'STREP', 'STREW', 'SWELL', 'SWEPT', 'TECHS', 'TEFFS', 'TEGGS', 'TELLS', 'TEMPS', 'TEMPT', 'TENCH', 'TENDS', 'TENTH', 'TENTS', 'TERMS', 'TERNS', 'TESTS', 'TETHS', 'TEXTS', 'THEFT', 'THEGN', 'THENS', 'THERM', 'THESP', 'THEWS', 'THREW', 'TREKS', 'TREND', 'TRESS', 'TRETS', 'TREWS', 'TSKED', 'TWERP', 'VELDS', 'VELDT', 'VENDS', 'VENTS', 'VERBS', 'VERST', 'VERTS', 'VESTS', 'VETCH', 'WECHT', 'WEFTS', 'WELCH', 'WELDS', 'WELLS', 'WELSH', 'WELTS', 'WENCH', 'WENDS', 'WESTS', 'WHELK', 'WHELM', 'WHELP', 'WHENS', 'WHETS', 'WHEWS', 'WRECK', 'WRENS', 'WREST', 'ZERKS', 'ZESTS'] 
EE: ['BEDEL', 'BEDEW', 'BEECH', 'BEEFS', 'BEEPS', 'BEERS', 'BEETS', 'BEGET', 'BELLE', 'BENES', 'BENNE', 'BERET', 'BERME', 'BESES', 'BESET', 'BETEL', 'BEVEL', 'BEZEL', 'BLEED', 'BLEEP', 'BREDE', 'BREED', 'BREES', 'BREVE', 'CEDED', 'CEDER', 'CEDES', 'CELEB', 'CENSE', 'CEPES', 'CERED', 'CERES', 'CETES', 'CHEEK', 'CHEEP', 'CHEER', 'CLEEK', 'CLEPE', 'CREED', 'CREEK', 'CREEL', 'CREEP', 'CREME', 'CREPE', 'DEEDS', 'DEEMS', 'DEEPS', 'DEERS', 'DEETS', 'DEFER', 'DEKED', 'DEKES', 'DELED', 'DELES', 'DELVE', 'DEMES', 'DENES', 'DENSE', 'DESEX', 'DETER', 'DEVEL', 'DEWED', 'DEXES', 'DREED', 'DREES', 'DWEEB', 'EBBED', 'EBBET', 'ECHED', 'ECHES', 'EDGED', 'EDGER', 'EDGES', 'EGERS', 'EGEST', 'EGGED', 'EGGER', 'EGRET', 'EJECT', 'ELDER', 'ELECT', 'ELVER', 'ELVES', 'EMBED', 'EMBER', 'EMEND', 'EMMER', 'EMMET', 'ENDED', 'ENDER', 'ENTER', 'ERECT', 'ERNES', 'ERRED', 'ERSES', 'ESKER', 'ESNES', 'ESSES', 'ESTER', 'ETHER', 'EVENS', 'EVENT', 'EVERT', 'EWERS', 'EXCEL', 'EXECS', 'EXERT', 'EXPEL', 'FECES', 'FEDEX', 'FEEBS', 'FEEDS', 'FEELS', 'FEMES', 'FEMME', 'FENCE', 'FERES', 'FESSE', 'FETED', 'FETES', 'FEVER', 'FEWER', 'FEZES', 'FLEER', 'FLEES', 'FLEET', 'FREED', 'FREER', 'FREES', 'FRERE', 'GEEKS', 'GEEST', 'GENES', 'GENET', 'GENRE', 'GESTE', 'GHEES', 'GLEBE', 'GLEDE', 'GLEED', 'GLEEK', 'GLEES', 'GLEET', 'GREBE', 'GREED', 'GREEK', 'GREEN', 'GREES', 'GREET', 'HEBES', 'HEDER', 'HEDGE', 'HEEDS', 'HEELS', 'HELVE', 'HEMES', 'HENCE', 'HENGE', 'HERES', 'HEWED', 'HEWER', 'HEXED', 'HEXER', 'HEXES', 'JEBEL', 'JEEPS', 'JEERS', 'JEFES', 'JESSE', 'JETES', 'JEWED', 'JEWEL', 'KEDGE', 'KEEFS', 'KEEKS', 'KEELS', 'KEENS', 'KEEPS', 'KEETS', 'KELEP', 'KENTE', 'KERNE', 'KEVEL', 'KEXES', 'KNEED', 'KNEEL', 'KNEES', 'KREEP', 'KREWE', 'LEBEN', 'LEDGE', 'LEECH', 'LEEKS', 'LEERS', 'LEETS', 'LEGER', 'LEGES', 'LENES', 'LENSE', 'LEPER', 'LESES', 'LETHE', 'LEVEL', 'LEVER', 'LEXES', 'MEEDS', 'MEETS', 'MEMES', 'MENSE', 'MERDE', 'MERER', 'MERES', 'MERGE', 'MERLE', 'MESNE', 'METED', 'METER', 'METES', 'METRE', 'MEWED', 'MEZES', 'NEEDS', 'NEEMS', 'NEEPS', 'NENES', 'NERVE', 'NEVER', 'NEVES', 'NEWEL', 'NEWER', 'NGWEE', 'PEDES', 'PEEKS', 'PEELS', 'PEENS', 'PEEPS', 'PEERS', 'PEKES', 'PELES', 'PENCE', 'PENES', 'PENNE', 'PERES', 'PERSE', 'PETER', 'PLEBE', 'PREED', 'PREEN', 'PREES', 'PRESE', 'REBBE', 'REBEC', 'REBEL', 'RECCE', 'REDED', 'REDES', 'REEDS', 'REEFS', 'REEKS', 'REELS', 'REEST', 'REFED', 'REFEL', 'REFER', 'REGES', 'REHEM', 'RELET', 'REMET', 'REMEX', 'RENEW', 'RENTE', 'REPEG', 'REPEL', 'RESET', 'RESEW', 'RETEM', 'REVEL', 'REVET', 'REWED', 'REWET', 'REXES', 'RHEME', 'SCENE', 'SCREE', 'SEDER', 'SEDGE', 'SEEDS', 'SEEKS', 'SEELS', 'SEEMS', 'SEEPS', 'SEERS', 'SELLE', 'SEMEN', 'SEMES', 'SENSE', 'SENTE', 'SERED', 'SERER', 'SERES', 'SERGE', 'SERVE', 'SEVEN', 'SEVER', 'SEWED', 'SEWER', 'SEXED', 'SEXES', 'SHEEN', 'SHEEP', 'SHEER', 'SHEET', 'SKEED', 'SKEEN', 'SKEES', 'SKEET', 'SKENE', 'SLEEK', 'SLEEP', 'SLEET', 'SMEEK', 'SNEER', 'SPEED', 'SPEEL', 'SPEER', 'SPREE', 'STEED', 'STEEK', 'STEEL', 'STEEP', 'STEER', 'STELE', 'STERE', 'SWEDE', 'SWEEP', 'SWEER', 'SWEET', 'TEELS', 'TEEMS', 'TEENS', 'TEETH', 'TELES', 'TELEX', 'TENET', 'TENGE', 'TENSE', 'TERCE', 'TERNE', 'TERSE', 'TEWED', 'THEBE', 'THEME', 'THERE', 'THESE', 'THREE', 'TREED', 'TREEN', 'TREES', 'TWEED', 'TWEEN', 'TWEET', 'VEEPS', 'VEERS', 'VEGES', 'VENGE', 'VERGE', 'VERSE', 'VERVE', 'VEXED', 'VEXER', 'VEXES', 'WEBER', 'WEDEL', 'WEDGE', 'WEEDS', 'WEEKS', 'WEENS', 'WEEPS', 'WEEST', 'WEETS', 'WHEEL', 'WHEEN', 'WHEEP', 'WHERE', 'XEBEC', 'ZEBEC'] 
EI: ['BEDIM', 'BEFIT', 'BEGIN', 'BEING', 'BEMIX', 'BENNI', 'BEWIG', 'BEZIL', 'CEBID', 'CEDIS', 'CEILS', 'CELLI', 'CERCI', 'CERIC', 'CESTI', 'DEBIT', 'DEFIS', 'DEIGN', 'DEILS', 'DEISM', 'DEIST', 'DELIS', 'DEMIC', 'DEMIT', 'DENIM', 'DEVIL', 'EDICT', 'EDITS', 'EIGHT', 'EKING', 'ELFIN', 'ELINT', 'EMIRS', 'EMITS', 'EPICS', 'ERVIL', 'ETHIC', 'EVICT', 'EVILS', 'EXING', 'EXIST', 'EXITS', 'FEIGN', 'FEINT', 'FEIST', 'FELID', 'FERMI', 'FETID', 'GELID', 'GENIC', 'GENIP', 'HEIGH', 'HEILS', 'HEIRS', 'HEIST', 'HELIX', 'HEMIC', 'HEMIN', 'JERID', 'KEFIR', 'KEIRS', 'KELIM', 'KEPIS', 'KEVIL', 'LEGIT', 'LENIS', 'LEVIN', 'LEVIS', 'LEWIS', 'LEXIS', 'LWEIS', 'MEDIC', 'MELIC', 'MERIT', 'MESIC', 'METIS', 'NEIFS', 'NEIGH', 'NEIST', 'PEINS', 'PEKIN', 'PENIS', 'PENNI', 'PERIL', 'PERIS', 'PETIT', 'PETTI', 'PEWIT', 'REBID', 'RECIT', 'RECTI', 'REDID', 'REDIP', 'REFIT', 'REFIX', 'REIFS', 'REIGN', 'REINK', 'REINS', 'REJIG', 'RELIC', 'RELIT', 'REMIT', 'REMIX', 'RENIG', 'RENIN', 'REPIN', 'RERIG', 'RESID', 'RESIN', 'RESIT', 'REWIN', 'SEGNI', 'SEIFS', 'SEISM', 'SEMIS', 'SENGI', 'SENTI', 'SEPIC', 'SERIF', 'SERIN', 'SHEIK', 'SKEIN', 'SPEIL', 'SPEIR', 'STEIN', 'TEIND', 'TELIC', 'TEMPI', 'TEPID', 'TETRI', 'THEIN', 'THEIR', 'VEILS', 'VEINS', 'VENIN', 'VEXIL', 'WEIGH', 'WEIRD', 'WEIRS', 'XENIC', 'XERIC', 'ZEINS'] 
EEI: ['BEEDI', 'ELEMI'] 
EEY: ['BEEFY', 'BEERY', 'DEEDY', 'ELEGY', 'EMERY', 'ENEMY', 'EVERY', 'GEEKY', 'LEERY', 'NEEDY', 'PEERY', 'REEDY', 'REEFY', 'REEKY', 'REKEY', 'SEEDY', 'SEELY', 'SEEPY', 'TEENY', 'VEERY', 'WEEDY', 'WEENY', 'WEEPY'] 
EU: ['BEGUM', 'BEGUN', 'CECUM', 'CENTU', 'DEBUG', 'DEBUT', 'DEGUM', 'DEMUR', 'ECRUS', 'EDUCT', 'ERUCT', 'ERUPT', 'EXULT', 'EXURB', 'FEMUR', 'FETUS', 'FEUDS', 'GENUS', 'GETUP', 'GEUMS', 'HEUCH', 'HEUGH', 'JEHUS', 'LEMUR', 'LETUP', 'LEUDS', 'MENUS', 'NEGUS', 'NEUKS', 'NEUMS', 'NEVUS', 'NEXUS', 'PERDU', 'PSEUD', 'REBUS', 'REBUT', 'RECUR', 'RECUT', 'REDUB', 'REDUX', 'RERUN', 'RHEUM', 'SEBUM', 'SEDUM', 'SERUM', 'SETUP', 'TENDU', 'TEUCH', 'TEUGH', 'VELUM', 'VENUS', 'VERTU', 'XERUS', 'ZEBUS'] 
EIE: ['BEIGE', 'BELIE', 'DEICE', 'DEXIE', 'EDILE', 'EIDER', 'ELIDE', 'ELITE', 'EVITE', 'EXILE', 'EXINE', 'GENIE', 'NEWIE', 'PEISE', 'REIVE', 'RETIE', 'SEINE', 'SEISE', 'SEIZE', 'VEGIE'] 
EIY: ['BEIGY', 'DEIFY', 'DEITY', 'EDIFY', 'MEINY', 'REIFY', 'VEINY'] 
EY: ['BELLY', 'BENDY', 'BENNY', 'BERRY', 'BERYL', 'CHEVY', 'CHEWY', 'CREPY', 'DECRY', 'DELLY', 'DERBY', 'DERRY', 'EMMYS', 'EMPTY', 'EMYDS', 'ENSKY', 'ENTRY', 'ENZYM', 'ETHYL', 'FELLY', 'FENNY', 'FERLY', 'FERNY', 'FERRY', 'FEZZY', 'FLEYS', 'GEMMY', 'GERMY', 'GLEYS', 'GREYS', 'HEDGY', 'HEFTY', 'HEMPY', 'HENRY', 'HERBY', 'HERRY', 'HEXYL', 'JELLY', 'JEMMY', 'JENNY', 'JERKY', 'JERRY', 'JETTY', 'KELLY', 'KELPY', 'KERRY', 'LEDGY', 'LEFTY', 'LEGGY', 'LEZZY', 'MELTY', 'MERCY', 'MERRY', 'MESHY', 'MESSY', 'NEDDY', 'NELLY', 'NERDY', 'NERVY', 'NETTY', 'NEWLY', 'NEWSY', 'PECKY', 'PENNY', 'PEPPY', 'PERDY', 'PERKY', 'PERRY', 'PESKY', 'PESTY', 'PETTY', 'PREXY', 'PREYS', 'REDLY', 'REDRY', 'REFLY', 'REFRY', 'REPLY', 'RETRY', 'SEDGY', 'SERRY', 'STEWY', 'TECHY', 'TEDDY', 'TELLY', 'TENTY', 'TERRY', 'TESTY', 'THEWY', 'TREYS', 'WEBBY', 'WEDGY', 'WELLY', 'WENNY', 'WETLY', 'WHEYS', 'ZESTY'] 
OO: ['BHOOT', 'BLOOD', 'BLOOM', 'BLOOP', 'BOFFO', 'BOHOS', 'BOLOS', 'BONGO', 'BOOBS', 'BOOKS', 'BOOMS', 'BOONS', 'BOORS', 'BOOST', 'BOOTH', 'BOOTS', 'BORON', 'BOSOM', 'BOSON', 'BOZOS', 'BROMO', 'BROOD', 'BROOK', 'BROOM', 'BROOS', 'CHOLO', 'CHOOK', 'CLOOT', 'COCOS', 'CODON', 'COGON', 'COHOG', 'COHOS', 'COLOG', 'COLON', 'COLOR', 'COMBO', 'COMPO', 'CONDO', 'CONGO', 'CONTO', 'COOCH', 'COOFS', 'COOKS', 'COOLS', 'COOMB', 'COONS', 'COOPS', 'COOPT', 'COOTS', 'CROOK', 'CROON', 'DOBRO', 'DODOS', 'DOGGO', 'DOJOS', 'DOLOR', 'DONOR', 'DOOMS', 'DOORS', 'DROOL', 'DROOP', 'FLOOD', 'FLOOR', 'FOODS', 'FOOLS', 'FOOTS', 'FORDO', 'FORGO', 'GLOOM', 'GOBOS', 'GOGOS', 'GOMBO', 'GONOF', 'GONZO', 'GOODS', 'GOOFS', 'GOOKS', 'GOONS', 'GOOPS', 'GROOM', 'HOBOS', 'HOLLO', 'HOMOS', 'HONOR', 'HOOCH', 'HOODS', 'HOOFS', 'HOOKS', 'HOOPS', 'HOOTS', 'JOCKO', 'JOMON', 'KLOOF', 'KOBOS', 'KOLOS', 'KOOKS', 'KOTOS', 'KOTOW', 'KROON', 'LOBOS', 'LOCOS', 'LOGON', 'LOGOS', 'LOOFS', 'LOOKS', 'LOOMS', 'LOONS', 'LOOPS', 'LOOTS', 'LOTOS', 'LOTTO', 'MOJOS', 'MOLTO', 'MONDO', 'MONGO', 'MONOS', 'MOOCH', 'MOODS', 'MOOLS', 'MOONS', 'MOORS', 'MOOTS', 'MORON', 'MORRO', 'MOSSO', 'MOTOR', 'MOTTO', 'MOZOS', 'NOHOW', 'NOLOS', 'NOMOS', 'NOOKS', 'NOONS', 'OBOLS', 'ODORS', 'OOMPH', 'ORDOS', 'ORLON', 'ORLOP', 'ORTHO', 'ORZOS', 'OSMOL', 'OTTOS', 'OXBOW', 'PHONO', 'PHOTO', 'POLOS', 'POMOS', 'POOCH', 'POODS', 'POOFS', 'POOHS', 'POOLS', 'POONS', 'POOPS', 'PORNO', 'POTTO', 'PROMO', 'PROOF', 'PROSO', 'ROBOT', 'RONDO', 'ROODS', 'ROOFS', 'ROOKS', 'ROOMS', 'ROOST', 'ROOTS', 'ROTOR', 'ROTOS', 'SCOOP', 'SCOOT', 'SHOOK', 'SHOOL', 'SHOON', 'SHOOS', 'SHOOT', 'SLOOP', 'SNOOD', 'SNOOK', 'SNOOL', 'SNOOP', 'SNOOT', 'SOCKO', 'SODOM', 'SOKOL', 'SOLDO', 'SOLON', 'SOLOS', 'SOOKS', 'SOOTH', 'SOOTS', 'SOPOR', 'SORGO', 'SOTOL', 'SPOOF', 'SPOOK', 'SPOOL', 'SPOON', 'SPOOR', 'STOOD', 'STOOK', 'STOOL', 'STOOP', 'SWOON', 'SWOOP', 'THORO', 'TONDO', 'TOOLS', 'TOONS', 'TOOTH', 'TOOTS', 'TOPOS', 'TOROS', 'TOROT', 'TORSO', 'TROOP', 'TROOZ', 'VROOM', 'WHOOF', 'WHOOP', 'WHOSO', 'WOODS', 'WOOFS', 'WOOLS', 'WOOPS', 'WOOSH', 'ZOOKS', 'ZOOMS', 'ZOONS'] 
U: ['BHUTS', 'BLUBS', 'BLUFF', 'BLUNT', 'BLURB', 'BLURS', 'BLURT', 'BLUSH', 'BRUGH', 'BRUNG', 'BRUNT', 'BRUSH', 'BRUSK', 'BRUTS', 'BUCKS', 'BUFFS', 'BUHLS', 'BUHRS', 'BULBS', 'BULKS', 'BULLS', 'BUMFS', 'BUMPH', 'BUMPS', 'BUNCH', 'BUNDS', 'BUNDT', 'BUNGS', 'BUNKS', 'BUNNS', 'BUNTS', 'BURBS', 'BURDS', 'BURGH', 'BURGS', 'BURLS', 'BURNS', 'BURNT', 'BURPS', 'BURRS', 'BURST', 'BUSKS', 'BUSTS', 'BUTCH', 'BUTTS', 'CHUBS', 'CHUCK', 'CHUFF', 'CHUGS', 'CHUMP', 'CHUMS', 'CHUNK', 'CHURL', 'CHURN', 'CHURR', 'CLUBS', 'CLUCK', 'CLUMP', 'CLUNG', 'CLUNK', 'CRUCK', 'CRUDS', 'CRUMB', 'CRUMP', 'CRUSH', 'CRUST', 'CUFFS', 'CULCH', 'CULLS', 'CULMS', 'CULTS', 'CUNTS', 'CURBS', 'CURCH', 'CURDS', 'CURFS', 'CURLS', 'CURNS', 'CURRS', 'CURST', 'CUSKS', 'CUSPS', 'CUTCH', 'DRUBS', 'DRUGS', 'DRUMS', 'DRUNK', 'DUCKS', 'DUCTS', 'DUFFS', 'DULLS', 'DUMBS', 'DUMPS', 'DUNCH', 'DUNGS', 'DUNKS', 'DUNTS', 'DURNS', 'DURRS', 'DURST', 'DUSKS', 'DUSTS', 'DUTCH', 'FLUBS', 'FLUFF', 'FLUMP', 'FLUNG', 'FLUNK', 'FLUSH', 'FRUGS', 'FRUMP', 'FUCKS', 'FULLS', 'FUNDS', 'FUNKS', 'FURLS', 'GLUGS', 'GLUMS', 'GLUTS', 'GRUBS', 'GRUFF', 'GRUMP', 'GRUNT', 'GUCKS', 'GUFFS', 'GULCH', 'GULFS', 'GULLS', 'GULPS', 'GUNKS', 'GURSH', 'GUSTS', 'HUCKS', 'HUFFS', 'HULKS', 'HULLS', 'HUMPH', 'HUMPS', 'HUNCH', 'HUNKS', 'HUNTS', 'HURDS', 'HURLS', 'HURST', 'HURTS', 'HUSKS', 'HUTCH', 'JUMPS', 'JUNKS', 'JUSTS', 'KLUTZ', 'KNURL', 'KNURS', 'LUCKS', 'LUFFS', 'LULLS', 'LUMPS', 'LUNCH', 'LUNGS', 'LUNKS', 'LUNTS', 'LURCH', 'LURKS', 'LUSTS', 'MUCKS', 'MUFFS', 'MUGGS', 'MULCH', 'MULCT', 'MULLS', 'MUMMS', 'MUMPS', 'MUNCH', 'MURKS', 'MURRS', 'MUSKS', 'MUSTH', 'MUSTS', 'MUTCH', 'MUTTS', 'NUDZH', 'NULLS', 'NUMBS', 'NURDS', 'NURLS', 'PHUTS', 'PLUCK', 'PLUGS', 'PLUMB', 'PLUMP', 'PLUMS', 'PLUNK', 'PLUSH', 'PUCKS', 'PUFFS', 'PULLS', 'PULPS', 'PUMPS', 'PUNCH', 'PUNGS', 'PUNKS', 'PUNTS', 'PURLS', 'PURRS', 'PUTTS', 'QURSH', 'RHUMB', 'RUCKS', 'RUDDS', 'RUFFS', 'RUMPS', 'RUNGS', 'RUNTS', 'RUSKS', 'RUSTS', 'RUTHS', 'SCHUL', 'SCRUB', 'SCRUM', 'SCUDS', 'SCUFF', 'SCULK', 'SCULL', 'SCULP', 'SCUMS', 'SCUPS', 'SCURF', 'SCUTS', 'SCUZZ', 'SHLUB', 'SHRUB', 'SHRUG', 'SHUCK', 'SHULN', 'SHULS', 'SHUNS', 'SHUNT', 'SHUSH', 'SHUTS', 'SKULK', 'SKULL', 'SKUNK', 'SLUBS', 'SLUFF', 'SLUGS', 'SLUMP', 'SLUMS', 'SLUNG', 'SLUNK', 'SLURB', 'SLURP', 'SLURS', 'SLUSH', 'SLUTS', 'SMUSH', 'SMUTS', 'SNUBS', 'SNUCK', 'SNUFF', 'SNUGS', 'SPRUG', 'SPUDS', 'SPUNK', 'SPURN', 'SPURS', 'SPURT', 'STRUM', 'STRUT', 'STUBS', 'STUCK', 'STUDS', 'STUFF', 'STULL', 'STUMP', 'STUMS', 'STUNG', 'STUNK', 'STUNS', 'STUNT', 'STURT', 'SUCKS', 'SUDDS', 'SUGHS', 'SULKS', 'SUMPS', 'SUNNS', 'SURDS', 'SURFS', 'SWUNG', 'THRUM', 'THUDS', 'THUGS', 'THUMB', 'THUMP', 'THUNK', 'THURL', 'TRUCK', 'TRUGS', 'TRULL', 'TRUMP', 'TRUNK', 'TRUSS', 'TRUST', 'TRUTH', 'TUCKS', 'TUFFS', 'TUFTS', 'TUMPS', 'TUNGS', 'TURDS', 'TURFS', 'TURKS', 'TURNS', 'TURPS', 'TUSKS', 'VUGGS', 'VUGHS', 'WHUMP', 'WHUPS', 'WRUNG', 'WURST'] 
IAI: ['BIALI', 'IAMBI', 'LITAI'] 
IAY: ['BIALY', 'DIARY', 'INLAY'] 
I: ['BIBBS', 'BIFFS', 'BIGHT', 'BILKS', 'BILLS', 'BINDS', 'BINTS', 'BIRCH', 'BIRDS', 'BIRKS', 'BIRLS', 'BIRRS', 'BIRTH', 'BISKS', 'BITCH', 'BITTS', 'BLIMP', 'BLIND', 'BLINK', 'BLIPS', 'BLISS', 'BLITZ', 'BRICK', 'BRIGS', 'BRILL', 'BRIMS', 'BRING', 'BRINK', 'BRINS', 'BRISK', 'BRISS', 'BRITH', 'BRITS', 'BRITT', 'CHICK', 'CHICS', 'CHILD', 'CHILL', 'CHIMB', 'CHIMP', 'CHINK', 'CHINS', 'CHIPS', 'CHIRK', 'CHIRM', 'CHIRP', 'CHIRR', 'CHITS', 'CINCH', 'CISTS', 'CLICK', 'CLIFF', 'CLIFT', 'CLIMB', 'CLING', 'CLINK', 'CLIPS', 'CLIPT', 'CRIBS', 'CRICK', 'CRIMP', 'CRISP', 'CRITS', 'DICKS', 'DIDST', 'DIFFS', 'DIGHT', 'DILLS', 'DINGS', 'DINKS', 'DINTS', 'DIRKS', 'DIRLS', 'DIRTS', 'DISCS', 'DISKS', 'DITCH', 'DJINN', 'DJINS', 'DRIBS', 'DRIFT', 'DRILL', 'DRINK', 'DRIPS', 'DRIPT', 'FIFTH', 'FIGHT', 'FILCH', 'FILLS', 'FILMS', 'FILTH', 'FINCH', 'FINDS', 'FINKS', 'FIRMS', 'FIRNS', 'FIRST', 'FIRTH', 'FISCS', 'FISTS', 'FITCH', 'FLICK', 'FLICS', 'FLING', 'FLINT', 'FLIPS', 'FLIRS', 'FLIRT', 'FLITS', 'FRIGS', 'FRILL', 'FRISK', 'FRITH', 'FRITS', 'FRITT', 'FRITZ', 'FRIZZ', 'GIFTS', 'GILDS', 'GILLS', 'GILTS', 'GIMPS', 'GINKS', 'GIRDS', 'GIRLS', 'GIRNS', 'GIRSH', 'GIRTH', 'GIRTS', 'GISTS', 'GLIFF', 'GLIMS', 'GLINT', 'GLITZ', 'GRIDS', 'GRIFF', 'GRIFT', 'GRIGS', 'GRILL', 'GRIND', 'GRINS', 'GRIPS', 'GRIPT', 'GRIST', 'GRITH', 'GRITS', 'HICKS', 'HIGHS', 'HIGHT', 'HILLS', 'HILTS', 'HINDS', 'HINTS', 'HISTS', 'HITCH', 'JIBBS', 'JIFFS', 'JILLS', 'JILTS', 'JINKS', 'JINNS', 'JISMS', 'KICKS', 'KILLS', 'KILNS', 'KILTS', 'KINDS', 'KINGS', 'KINKS', 'KIRKS', 'KIRNS', 'KISTS', 'KITHS', 'KLICK', 'KLIKS', 'KNISH', 'KNITS', 'KRILL', 'LICHT', 'LICKS', 'LIFTS', 'LIGHT', 'LILTS', 'LIMBS', 'LIMNS', 'LIMPS', 'LINGS', 'LINKS', 'LINNS', 'LINTS', 'LISPS', 'LISTS', 'MICKS', 'MIDST', 'MIFFS', 'MIGGS', 'MIGHT', 'MILCH', 'MILDS', 'MILKS', 'MILLS', 'MILTS', 'MINDS', 'MINKS', 'MINTS', 'MIRKS', 'MIRTH', 'MISTS', 'MITTS', 'NICKS', 'NIGHS', 'NIGHT', 'NILLS', 'NINTH', 'PICKS', 'PILLS', 'PIMPS', 'PINCH', 'PINGS', 'PINKS', 'PINTS', 'PIRNS', 'PITCH', 'PITHS', 'PLINK', 'PRICK', 'PRIGS', 'PRILL', 'PRIMP', 'PRIMS', 'PRINK', 'PRINT', 'PRISM', 'PRISS', 'RICKS', 'RIFFS', 'RIFTS', 'RIGHT', 'RILLS', 'RINDS', 'RINGS', 'RINKS', 'RISKS', 'SCRIM', 'SCRIP', 'SHIFT', 'SHILL', 'SHIMS', 'SHINS', 'SHIPS', 'SHIRK', 'SHIRR', 'SHIRT', 'SHIST', 'SHITS', 'SHIVS', 'SHRIS', 'SHTIK', 'SIBBS', 'SICKS', 'SIFTS', 'SIGHS', 'SIGHT', 'SIGNS', 'SILDS', 'SILKS', 'SILLS', 'SILTS', 'SIMPS', 'SINGS', 'SINHS', 'SINKS', 'SIXTH', 'SKIDS', 'SKIFF', 'SKILL', 'SKIMP', 'SKIMS', 'SKINK', 'SKINS', 'SKINT', 'SKIPS', 'SKIRL', 'SKIRR', 'SKIRT', 'SKITS', 'SLICK', 'SLIMS', 'SLING', 'SLINK', 'SLIPS', 'SLIPT', 'SLITS', 'SMIRK', 'SMITH', 'SNIBS', 'SNICK', 'SNIFF', 'SNIPS', 'SNITS', 'SPICK', 'SPICS', 'SPIFF', 'SPIKS', 'SPILL', 'SPILT', 'SPINS', 'SPIRT', 'SPITS', 'SPITZ', 'SPIVS', 'SPLIT', 'SPRIG', 'SPRIT', 'STICH', 'STICK', 'STIFF', 'STILL', 'STILT', 'STING', 'STINK', 'STINT', 'STIRK', 'STIRP', 'STIRS', 'STRIP', 'SWIFT', 'SWIGS', 'SWILL', 'SWIMS', 'SWING', 'SWINK', 'SWIRL', 'SWISH', 'SWISS', 'SWITH', 'THICK', 'THIGH', 'THILL', 'THING', 'THINK', 'THINS', 'THIRD', 'THIRL', 'THRIP', 'TICKS', 'TIFFS', 'TIGHT', 'TILLS', 'TILTH', 'TILTS', 'TINCT', 'TINGS', 'TINTS', 'TIRLS', 'TRICK', 'TRIGS', 'TRILL', 'TRIMS', 'TRIPS', 'TWIGS', 'TWILL', 'TWINS', 'TWIRL', 'TWIRP', 'TWIST', 'TWITS', 'TWIXT', 'VILLS', 'VIRLS', 'WHICH', 'WHIDS', 'WHIFF', 'WHIGS', 'WHIMS', 'WHINS', 'WHIPS', 'WHIPT', 'WHIRL', 'WHIRR', 'WHIRS', 'WHISH', 'WHISK', 'WHIST', 'WHITS', 'WHIZZ', 'WICKS', 'WIDTH', 'WIGHT', 'WILDS', 'WILLS', 'WILTS', 'WIMPS', 'WINCH', 'WINDS', 'WINGS', 'WINKS', 'WISPS', 'WISTS', 'WITCH', 'WRICK', 'WRING', 'WRIST', 'WRITS', 'ZILCH', 'ZILLS', 'ZINCS', 'ZINGS'] 
IE: ['BIBLE', 'BICEP', 'BICES', 'BIDED', 'BIDER', 'BIDES', 'BIDET', 'BIELD', 'BIERS', 'BIKED', 'BIKER', 'BIKES', 'BILES', 'BILGE', 'BINER', 'BINES', 'BINGE', 'BIPED', 'BIRLE', 'BIRSE', 'BISES', 'BITER', 'BITES', 'BIZES', 'BLITE', 'BRIBE', 'BRIDE', 'BRIEF', 'BRIER', 'BRIES', 'BRINE', 'CHIDE', 'CHIEF', 'CHIEL', 'CHILE', 'CHIME', 'CHINE', 'CHIVE', 'CIDER', 'CIMEX', 'CINES', 'CIRES', 'CITED', 'CITER', 'CITES', 'CIVET', 'CLIME', 'CLINE', 'CRIED', 'CRIER', 'CRIES', 'CRIME', 'CRIPE', 'DICED', 'DICER', 'DICES', 'DIETS', 'DIKED', 'DIKER', 'DIKES', 'DIMER', 'DIMES', 'DINED', 'DINER', 'DINES', 'DINGE', 'DIRER', 'DIRGE', 'DISME', 'DITES', 'DIVED', 'DIVER', 'DIVES', 'DIZEN', 'DRIED', 'DRIER', 'DRIES', 'DRIVE', 'DWINE', 'FIBER', 'FIBRE', 'FICES', 'FICHE', 'FIDGE', 'FIEFS', 'FIELD', 'FIEND', 'FIFED', 'FIFER', 'FIFES', 'FILED', 'FILER', 'FILES', 'FILET', 'FILLE', 'FINED', 'FINER', 'FINES', 'FIRED', 'FIRER', 'FIRES', 'FIVER', 'FIVES', 'FIXED', 'FIXER', 'FIXES', 'FLIED', 'FLIER', 'FLIES', 'FLITE', 'FRIED', 'FRIER', 'FRIES', 'FRISE', 'GIBED', 'GIBER', 'GIBES', 'GIGHE', 'GIMEL', 'GIMME', 'GITES', 'GIVEN', 'GIVER', 'GIVES', 'GLIDE', 'GLIME', 'GRIDE', 'GRIEF', 'GRIME', 'GRIPE', 'GWINE', 'HIDED', 'HIDER', 'HIDES', 'HIKED', 'HIKER', 'HIKES', 'HINGE', 'HIRED', 'HIRER', 'HIRES', 'HIVED', 'HIVES', 'ICKER', 'IDLED', 'IDLER', 'IDLES', 'IGGED', 'ILLER', 'IMBED', 'IMPED', 'IMPEL', 'INDEX', 'INEPT', 'INERT', 'INFER', 'INGLE', 'INKED', 'INKER', 'INKLE', 'INLET', 'INNED', 'INNER', 'INSET', 'INTER', 'IRKED', 'ISLED', 'ISLES', 'ISLET', 'ISTLE', 'ITEMS', 'ITHER', 'IXTLE', 'JIBED', 'JIBER', 'JIBES', 'JIVED', 'JIVER', 'JIVES', 'KIBBE', 'KIBES', 'KIEFS', 'KIERS', 'KIKES', 'KINES', 'KITED', 'KITER', 'KITES', 'KITHE', 'KNIFE', 'LIBEL', 'LIBER', 'LIENS', 'LIERS', 'LIFER', 'LIGER', 'LIKED', 'LIKEN', 'LIKER', 'LIKES', 'LIMED', 'LIMEN', 'LIMES', 'LINED', 'LINEN', 'LINER', 'LINES', 'LISLE', 'LITER', 'LITHE', 'LITRE', 'LIVED', 'LIVEN', 'LIVER', 'LIVES', 'LIVRE', 'MICHE', 'MIDGE', 'MIENS', 'MIKED', 'MIKES', 'MILER', 'MILES', 'MILLE', 'MIMED', 'MIMER', 'MIMES', 'MINCE', 'MINED', 'MINER', 'MINES', 'MINKE', 'MIRED', 'MIRES', 'MIREX', 'MISER', 'MISES', 'MITER', 'MITES', 'MITRE', 'MIXED', 'MIXER', 'MIXES', 'MIZEN', 'NICER', 'NICHE', 'NIDED', 'NIDES', 'NINES', 'NITER', 'NITES', 'NITRE', 'NIXED', 'NIXES', 'PIERS', 'PIKED', 'PIKER', 'PIKES', 'PILED', 'PILES', 'PINED', 'PINES', 'PIPED', 'PIPER', 'PIPES', 'PIPET', 'PISTE', 'PIXEL', 'PIXES', 'PLIED', 'PLIER', 'PLIES', 'PRICE', 'PRIDE', 'PRIED', 'PRIER', 'PRIES', 'PRIME', 'PRISE', 'PRIZE', 'RIBES', 'RICED', 'RICER', 'RICES', 'RIDER', 'RIDES', 'RIDGE', 'RIELS', 'RIFER', 'RIFLE', 'RILED', 'RILES', 'RILLE', 'RIMED', 'RIMER', 'RIMES', 'RINSE', 'RIPED', 'RIPEN', 'RIPER', 'RIPES', 'RISEN', 'RISER', 'RISES', 'RITES', 'RIVED', 'RIVEN', 'RIVER', 'RIVES', 'RIVET', 'SHIED', 'SHIEL', 'SHIER', 'SHIES', 'SHINE', 'SHIRE', 'SHIVE', 'SICES', 'SIDED', 'SIDES', 'SIDHE', 'SIDLE', 'SIKER', 'SIKES', 'SILEX', 'SINCE', 'SINES', 'SINEW', 'SINGE', 'SIPED', 'SIPES', 'SIRED', 'SIREN', 'SIRES', 'SISES', 'SITED', 'SITES', 'SIVER', 'SIXES', 'SIXTE', 'SIZED', 'SIZER', 'SIZES', 'SKIED', 'SKIER', 'SKIES', 'SKITE', 'SKIVE', 'SLICE', 'SLIDE', 'SLIER', 'SLIME', 'SLIPE', 'SMILE', 'SMITE', 'SNIDE', 'SNIPE', 'SPICE', 'SPIED', 'SPIEL', 'SPIER', 'SPIES', 'SPIKE', 'SPILE', 'SPINE', 'SPIRE', 'SPITE', 'STIED', 'STIES', 'STILE', 'STIME', 'STIPE', 'SWINE', 'SWIPE', 'SWIVE', 'THIEF', 'THINE', 'TIDED', 'TIDES', 'TIERS', 'TIGER', 'TIKES', 'TILDE', 'TILED', 'TILER', 'TILES', 'TIMED', 'TIMER', 'TIMES', 'TINED', 'TINES', 'TINGE', 'TIRED', 'TIRES', 'TITER', 'TITHE', 'TITLE', 'TITRE', 'TRIBE', 'TRICE', 'TRIED', 'TRIER', 'TRIES', 'TRIKE', 'TRINE', 'TRIPE', 'TRITE', 'TWICE', 'TWIER', 'TWINE', 'VIBES', 'VICED', 'VICES', 'VIERS', 'VIEWS', 'VILER', 'VIMEN', 'VINED', 'VINES', 'VIPER', 'VIRES', 'VISED', 'VISES', 'VIXEN', 'WHILE', 'WHINE', 'WHITE', 'WIDEN', 'WIDER', 'WIDES', 'WIELD', 'WIFED', 'WIFES', 'WILED', 'WILES', 'WINCE', 'WINED', 'WINES', 'WINZE', 'WIPED', 'WIPER', 'WIPES', 'WIRED', 'WIRER', 'WIRES', 'WISED', 'WISER', 'WISES', 'WITED', 'WITES', 'WITHE', 'WIVED', 'WIVER', 'WIVES', 'WIZEN', 'WIZES', 'WRIED', 'WRIER', 'WRIES', 'WRITE', 'ZIBET', 'ZINEB', 'ZINES'] 
IY: ['BIDDY', 'BIFFY', 'BIGGY', 'BIGLY', 'BILBY', 'BILGY', 'BILLY', 'BITSY', 'BITTY', 'BLIMY', 'BRINY', 'CHIVY', 'CISSY', 'CIVVY', 'DICKY', 'DICTY', 'DILLY', 'DIMLY', 'DINGY', 'DINKY', 'DIPPY', 'DIRTY', 'DISHY', 'DITSY', 'DITTY', 'DITZY', 'DIVVY', 'DIZZY', 'DRILY', 'FIFTY', 'FILLY', 'FILMY', 'FINNY', 'FIRRY', 'FISHY', 'FITLY', 'FIZZY', 'GIDDY', 'GILLY', 'GIMPY', 'GINNY', 'GIPSY', 'GIRLY', 'GRIMY', 'GRIPY', 'HILLY', 'HINKY', 'HINNY', 'HIPLY', 'HIPPY', 'HISSY', 'IDYLL', 'IDYLS', 'IMPLY', 'ITCHY', 'JIFFY', 'JIGGY', 'JIMMY', 'JIMPY', 'KICKY', 'KIDDY', 'KILTY', 'KINKY', 'KISSY', 'KITTY', 'LIMBY', 'LINDY', 'LINGY', 'LINKY', 'LINTY', 'LIPPY', 'MIDDY', 'MIFFY', 'MILKY', 'MILTY', 'MINCY', 'MINGY', 'MINNY', 'MINTY', 'MIRKY', 'MISSY', 'MISTY', 'NIFTY', 'NINNY', 'NIPPY', 'NITTY', 'PICKY', 'PIGGY', 'PIGMY', 'PINKY', 'PINNY', 'PITHY', 'PRICY', 'PRIVY', 'RIBBY', 'RIDGY', 'RINDY', 'RISKY', 'RITZY', 'SHILY', 'SHINY', 'SIBYL', 'SILKY', 'SILLY', 'SILTY', 'SISSY', 'SIXTY', 'SLILY', 'SLIMY', 'SPICY', 'SPIKY', 'SPINY', 'SPIRY', 'STIMY', 'TINNY', 'TIPPY', 'TIPSY', 'TITTY', 'TIZZY', 'TWINY', 'VICHY', 'VINYL', 'WHINY', 'WHITY', 'WIDDY', 'WIFTY', 'WIGGY', 'WILLY', 'WIMPY', 'WINDY', 'WINGY', 'WISPY', 'WITHY', 'WITTY', 'ZINCY', 'ZINGY', 'ZINKY', 'ZIPPY'] 
II: ['BIDIS', 'BIFID', 'BINDI', 'BINIT', 'BLINI', 'CHILI', 'CIRRI', 'CIVIC', 'CIVIL', 'DIGIT', 'DISCI', 'DIXIT', 'FICIN', 'FILMI', 'FINIS', 'FIXIT', 'ICING', 'ICTIC', 'IMIDS', 'IMMIX', 'IMPIS', 'INDRI', 'INFIX', 'INTIS', 'IRIDS', 'IRING', 'JINNI', 'KIBBI', 'KILIM', 'KININ', 'KIWIS', 'LIBRI', 'LICHI', 'LICIT', 'LIMBI', 'LIMIT', 'LININ', 'LIPID', 'LIPIN', 'LIVID', 'MIDIS', 'MIMIC', 'MINIM', 'MINIS', 'MIRIN', 'MITIS', 'NIHIL', 'NIMBI', 'NITID', 'PIING', 'PIKIS', 'PILIS', 'PIPIT', 'PRIMI', 'RICIN', 'RIGID', 'RISHI', 'SIGIL', 'TIKIS', 'TIMID', 'TIPIS', 'TITIS', 'VIGIL', 'VILLI', 'VINIC', 'VIRID', 'VISIT', 'VIVID', 'VIZIR', 'ZITIS', 'ZIZIT'] 
IO: ['BIGOS', 'BIGOT', 'BILBO', 'BIMBO', 'BINGO', 'BIOGS', 'BIONT', 'BIPOD', 'BIROS', 'BISON', 'BRIOS', 'CHICO', 'CHINO', 'CHIRO', 'CIBOL', 'CIONS', 'CISCO', 'DICOT', 'DIDOS', 'DILDO', 'DINGO', 'DINOS', 'DIOLS', 'DIPSO', 'DISCO', 'DITTO', 'DIVOT', 'FIDOS', 'FILLO', 'FILOS', 'FINOS', 'FIORD', 'GIGOT', 'GINZO', 'GIPON', 'GIRON', 'GIROS', 'GISMO', 'GIZMO', 'GRIOT', 'HILLO', 'HIPPO', 'ICHOR', 'ICONS', 'IDOLS', 'IKONS', 'INCOG', 'INDOL', 'INDOW', 'INFOS', 'INGOT', 'INTRO', 'IRONS', 'JINGO', 'KIDDO', 'KILOS', 'KINOS', 'KIOSK', 'LIDOS', 'LILOS', 'LIMBO', 'LIMOS', 'LINGO', 'LINOS', 'LIONS', 'LIROT', 'LITHO', 'MICRO', 'MILOS', 'MINOR', 'MISDO', 'MISOS', 'NICOL', 'NINON', 'NITON', 'NITRO', 'PICOT', 'PILOT', 'PINGO', 'PINKO', 'PINON', 'PINOT', 'PINTO', 'PIONS', 'PIROG', 'PISCO', 'PISOS', 'PITON', 'PIVOT', 'PRIMO', 'PRION', 'PRIOR', 'RHINO', 'RIGOR', 'RIOTS', 'SCION', 'SICKO', 'SILOS', 'SIXMO', 'SKIMO', 'THIOL', 'TIGON', 'TIROS', 'TRIGO', 'TRIOL', 'TRIOS', 'VIGOR', 'VINOS', 'VIOLS', 'VISOR', 'VIZOR', 'WIDOW', 'WILCO', 'WINOS'] 
IOU: ['BIJOU', 'PIOUS'] 
IIE: ['BIKIE', 'CIVIE', 'DIDIE', 'ICIER', 'IMIDE', 'IMINE', 'INDIE', 'IVIED', 'IVIES', 'NIXIE', 'PIXIE'] 
IA: ['BIMAH', 'BIMAS', 'BINAL', 'BRIAR', 'CHIAS', 'CHICA', 'CHINA', 'CIGAR', 'CIRCA', 'CNIDA', 'DIALS', 'DICTA', 'DINAR', 'DIRAM', 'DITAS', 'DIVAN', 'DIVAS', 'DIWAN', 'FIARS', 'FIATS', 'FILAR', 'FINAL', 'FINCA', 'FRIAR', 'GIANT', 'GIGAS', 'GLIAL', 'GLIAS', 'HIJAB', 'HIJRA', 'HILAR', 'IAMBS', 'IHRAM', 'IKATS', 'IMAMS', 'INAPT', 'INARM', 'INFRA', 'INVAR', 'ISBAS', 'IZARS', 'JIHAD', 'KIANG', 'KIBLA', 'KINAS', 'KIVAS', 'LIANG', 'LIARD', 'LIARS', 'LIBRA', 'LIDAR', 'LIGAN', 'LILAC', 'LIMAN', 'LIMAS', 'LIMBA', 'LIMPA', 'LINAC', 'LINGA', 'LIRAS', 'LITAS', 'MBIRA', 'MIASM', 'MICAS', 'MICRA', 'MIKRA', 'MILPA', 'MINAS', 'MIRZA', 'NICAD', 'NIDAL', 'NINJA', 'NIPAS', 'NIVAL', 'NIZAM', 'PHIAL', 'PIANS', 'PIBAL', 'PICAL', 'PICAS', 'PIKAS', 'PILAF', 'PILAR', 'PILAW', 'PIMAS', 'PINAS', 'PINNA', 'PINTA', 'PIPAL', 'PITAS', 'PITTA', 'PIZZA', 'PLICA', 'PRIMA', 'RIALS', 'RIANT', 'RIVAL', 'SHIVA', 'SIALS', 'SIGLA', 'SIGMA', 'SIGNA', 'SIKAS', 'SILVA', 'SIMAR', 'SIMAS', 'SIRRA', 'SISAL', 'SITAR', 'SIZAR', 'SPICA', 'STRIA', 'TICAL', 'TIDAL', 'TIKKA', 'TILAK', 'TITAN', 'TRIAC', 'TRIAD', 'TRIAL', 'VIALS', 'VIAND', 'VICAR', 'VIGAS', 'VILLA', 'VINAL', 'VINAS', 'VINCA', 'VIRAL', 'VIRGA', 'VISAS', 'VISTA', 'VITAL', 'VITTA', 'VIVAS', 'WICCA', 'WIGAN', 'WIRRA', 'WISHA', 'WITAN', 'ZIRAM'] 
IOE: ['BIOME', 'DIODE', 'IRONE'] 
IOA: ['BIOTA', 'IOTAS', 'IXORA', 'RIOJA', 'VIOLA'] 
OA: ['BLOAT', 'BOARD', 'BOARS', 'BOART', 'BOAST', 'BOATS', 'BOGAN', 'BOLAR', 'BOLAS', 'BORAL', 'BORAS', 'BORAX', 'BOTAS', 'BROAD', 'CHOLA', 'CLOAK', 'COACH', 'COACT', 'COALS', 'COAPT', 'COAST', 'COATS', 'COBRA', 'COCAS', 'CODAS', 'COLAS', 'COLZA', 'COMAL', 'COMAS', 'COMMA', 'CONGA', 'COPAL', 'COPRA', 'CORAL', 'COSTA', 'COTAN', 'COTTA', 'COXAL', 'CROAK', 'DOATS', 'DOBLA', 'DOBRA', 'DOGMA', 'DOLMA', 'DOMAL', 'DONAS', 'DONGA', 'DONNA', 'DOPAS', 'DORSA', 'DOTAL', 'FLOAT', 'FLORA', 'FLOTA', 'FOALS', 'FOAMS', 'FOCAL', 'FORAM', 'FOSSA', 'GLOAM', 'GLOAT', 'GOADS', 'GOALS', 'GOATS', 'GOBAN', 'GONAD', 'GORAL', 'GOWAN', 'GROAN', 'GROAT', 'HOARD', 'HOARS', 'HODAD', 'HOGAN', 'HOLLA', 'HONAN', 'HONDA', 'HORAH', 'HORAL', 'HORAS', 'HOSTA', 'JORAM', 'JOTAS', 'JOWAR', 'KOANS', 'KOLAS', 'KOPPA', 'KORAS', 'KORAT', 'KORMA', 'KRONA', 'LOACH', 'LOADS', 'LOAFS', 'LOAMS', 'LOANS', 'LOATH', 'LOBAR', 'LOCAL', 'LOGAN', 'LORAL', 'LORAN', 'LOTAH', 'LOTAS', 'LOVAT', 'MOANS', 'MOATS', 'MOCHA', 'MODAL', 'MOLAL', 'MOLAR', 'MOLAS', 'MOMMA', 'MONAD', 'MONAS', 'MORAL', 'MORAS', 'MOXAS', 'NODAL', 'NOMAD', 'NOMAS', 'NONAS', 'NOPAL', 'NOTAL', 'NOVAS', 'OASTS', 'OATHS', 'OCTAD', 'OCTAL', 'OCTAN', 'ODAHS', 'OFFAL', 'OGAMS', 'OGHAM', 'OKRAS', 'OLLAS', 'OPAHS', 'OPALS', 'ORACH', 'ORALS', 'ORANG', 'ORCAS', 'ORGAN', 'OTTAR', 'OVALS', 'POACH', 'POLAR', 'POLKA', 'POPPA', 'PROAS', 'PSOAS', 'ROACH', 'ROADS', 'ROAMS', 'ROANS', 'ROARS', 'ROAST', 'ROMAN', 'ROTAS', 'ROWAN', 'SHOAL', 'SHOAT', 'SKOAL', 'SOAKS', 'SOAPS', 'SOARS', 'SOBAS', 'SOCAS', 'SODAS', 'SOFAR', 'SOFAS', 'SOFTA', 'SOJAS', 'SOLAN', 'SOLAR', 'SOMAN', 'SOMAS', 'SONAR', 'SORAS', 'SORTA', 'SOWAR', 'STOAS', 'STOAT', 'STOMA', 'TOADS', 'TOAST', 'TOGAS', 'TOLAN', 'TOLAR', 'TOLAS', 'TOMAN', 'TONAL', 'TONGA', 'TOPAZ', 'TORAH', 'TORAS', 'TORTA', 'TOTAL', 'TROAK', 'TRONA', 'VOCAB', 'VOCAL', 'VODKA', 'VOLAR', 'VOLTA', 'VOLVA', 'WOADS', 'WOALD', 'WOMAN', 'ZONAL'] 
O: ['BLOBS', 'BLOCK', 'BLOCS', 'BLOGS', 'BLOND', 'BLOTS', 'BLOWN', 'BLOWS', 'BOCKS', 'BOFFS', 'BOLDS', 'BOLLS', 'BOLTS', 'BOMBS', 'BONDS', 'BONGS', 'BONKS', 'BORKS', 'BORTS', 'BORTZ', 'BOSKS', 'BOTCH', 'BOTTS', 'BOWLS', 'BROCK', 'BRONC', 'BROTH', 'BROWN', 'BROWS', 'CHOCK', 'CHOMP', 'CHOPS', 'CHORD', 'CHOTT', 'CHOWS', 'CLOCK', 'CLODS', 'CLOGS', 'CLOMB', 'CLOMP', 'CLONK', 'CLONS', 'CLOPS', 'CLOTH', 'CLOTS', 'CLOWN', 'COBBS', 'COCKS', 'COFFS', 'COLDS', 'COLTS', 'COMBS', 'COMPS', 'COMPT', 'CONCH', 'CONKS', 'CONNS', 'CORDS', 'CORKS', 'CORMS', 'CORNS', 'CORPS', 'COSTS', 'COWLS', 'CROCK', 'CROCS', 'CROFT', 'CROPS', 'CROSS', 'CROWD', 'CROWN', 'CROWS', 'DHOWS', 'DOCKS', 'DOFFS', 'DOLLS', 'DOLTS', 'DONGS', 'DORKS', 'DORMS', 'DORPS', 'DORRS', 'DOWNS', 'DROLL', 'DROPS', 'DROPT', 'DROSS', 'DROWN', 'FJORD', 'FLOCK', 'FLOCS', 'FLOGS', 'FLONG', 'FLOPS', 'FLOSS', 'FLOWN', 'FLOWS', 'FOHNS', 'FOLDS', 'FOLKS', 'FONDS', 'FONTS', 'FORBS', 'FORDS', 'FORKS', 'FORMS', 'FORTH', 'FORTS', 'FOWLS', 'FROCK', 'FROGS', 'FROND', 'FRONS', 'FRONT', 'FROSH', 'FROST', 'FROTH', 'FROWN', 'FROWS', 'GHOST', 'GLOBS', 'GLOGG', 'GLOMS', 'GLOPS', 'GLOSS', 'GLOST', 'GLOWS', 'GOLDS', 'GOLFS', 'GONGS', 'GORMS', 'GORPS', 'GOTHS', 'GOWDS', 'GOWKS', 'GOWNS', 'GROGS', 'GROKS', 'GROSS', 'GROSZ', 'GROTS', 'GROWL', 'GROWN', 'GROWS', 'HOCKS', 'HOGGS', 'HOLDS', 'HOLKS', 'HOLMS', 'HOLTS', 'HONGS', 'HONKS', 'HORNS', 'HORST', 'HOSTS', 'HOTCH', 'HOWFF', 'HOWFS', 'HOWKS', 'HOWLS', 'JOCKS', 'JOHNS', 'JOLTS', 'JOWLS', 'KLONG', 'KNOBS', 'KNOCK', 'KNOLL', 'KNOPS', 'KNOSP', 'KNOTS', 'KNOWN', 'KNOWS', 'KOHLS', 'KONKS', 'KOPHS', 'LOCHS', 'LOCKS', 'LOFTS', 'LOLLS', 'LONGS', 'LORDS', 'MOCKS', 'MOLDS', 'MOLLS', 'MOLTS', 'MONKS', 'MONTH', 'MORNS', 'MORPH', 'MORTS', 'MOSKS', 'MOSTS', 'MOTHS', 'MOTTS', 'NOCKS', 'NOGGS', 'NORMS', 'NORTH', 'NOTCH', 'NOWTS', 'PHLOX', 'PHONS', 'PHOTS', 'PLODS', 'PLONK', 'PLOPS', 'PLOTS', 'PLOTZ', 'PLOWS', 'POCKS', 'POLLS', 'POMPS', 'PONDS', 'PONGS', 'PORCH', 'PORKS', 'PORNS', 'PORTS', 'POSTS', 'PRODS', 'PROFS', 'PROGS', 'PROMS', 'PRONG', 'PROPS', 'PROSS', 'PROST', 'PROWL', 'PROWS', 'QOPHS', 'RHOMB', 'ROCKS', 'ROLFS', 'ROLLS', 'ROMPS', 'ROTCH', 'ROTLS', 'ROWTH', 'SCHMO', 'SCOFF', 'SCOLD', 'SCOPS', 'SCORN', 'SCOTS', 'SCOWL', 'SCOWS', 'SCROD', 'SHOCK', 'SHOGS', 'SHOPS', 'SHORL', 'SHORN', 'SHORT', 'SHOTS', 'SHOTT', 'SHOWN', 'SHOWS', 'SKORT', 'SKOSH', 'SLOBS', 'SLOGS', 'SLOJD', 'SLOPS', 'SLOSH', 'SLOTH', 'SLOTS', 'SLOWS', 'SMOCK', 'SMOGS', 'SMOLT', 'SNOBS', 'SNOGS', 'SNORT', 'SNOTS', 'SNOWS', 'SOCKS', 'SOFTS', 'SONGS', 'SOPHS', 'SORBS', 'SORDS', 'SORNS', 'SORTS', 'SOTHS', 'SPORT', 'SPOTS', 'STOBS', 'STOCK', 'STOMP', 'STOPS', 'STOPT', 'STORK', 'STORM', 'STOSS', 'STOTS', 'STOTT', 'STOWP', 'STOWS', 'STROP', 'STROW', 'SWOBS', 'SWOPS', 'SWORD', 'SWORN', 'SWOTS', 'THONG', 'THORN', 'THORP', 'THROB', 'THROW', 'TOFFS', 'TOFTS', 'TOLLS', 'TOMBS', 'TONGS', 'TOPHS', 'TORCH', 'TORCS', 'TORRS', 'TORSK', 'TORTS', 'TOWNS', 'TROCK', 'TROGS', 'TROLL', 'TROMP', 'TROTH', 'TROTS', 'TROWS', 'VOLTS', 'VROWS', 'WHOMP', 'WHOPS', 'WHORL', 'WHORT', 'WOLDS', 'WOLFS', 'WOMBS', 'WONKS', 'WONTS', 'WORDS', 'WORKS', 'WORLD', 'WORMS', 'WORST', 'WORTH', 'WORTS', 'WRONG', 'WROTH', 'ZONKS'] 
OE: ['BLOKE', 'BOCCE', 'BOCHE', 'BODED', 'BODES', 'BOGLE', 'BOLES', 'BOMBE', 'BONED', 'BONER', 'BONES', 'BONNE', 'BONZE', 'BORED', 'BORER', 'BORES', 'BORNE', 'BOTEL', 'BOWED', 'BOWEL', 'BOWER', 'BOWSE', 'BOXED', 'BOXER', 'BOXES', 'BROKE', 'BROME', 'BROSE', 'CHOKE', 'CHORE', 'CHOSE', 'CLONE', 'CLOSE', 'CLOVE', 'CLOZE', 'COBLE', 'CODEC', 'CODED', 'CODEN', 'CODER', 'CODES', 'CODEX', 'COEDS', 'COKED', 'COKES', 'COLED', 'COLES', 'COMBE', 'COMER', 'COMES', 'COMET', 'COMTE', 'CONED', 'CONES', 'CONGE', 'CONTE', 'COPED', 'COPEN', 'COPER', 'COPES', 'COPSE', 'CORED', 'CORER', 'CORES', 'CORSE', 'COSEC', 'COSES', 'COSET', 'COTED', 'COTES', 'COVED', 'COVEN', 'COVER', 'COVES', 'COVET', 'COWED', 'COWER', 'COXED', 'COXES', 'COZEN', 'COZES', 'CRONE', 'CRORE', 'CROZE', 'DHOLE', 'DODGE', 'DOERS', 'DOEST', 'DOETH', 'DOGES', 'DOLCE', 'DOLED', 'DOLES', 'DOMED', 'DOMES', 'DONNE', 'DOPED', 'DOPER', 'DOPES', 'DOSED', 'DOSER', 'DOSES', 'DOTED', 'DOTER', 'DOTES', 'DOVEN', 'DOVES', 'DOWED', 'DOWEL', 'DOWER', 'DOWSE', 'DOZED', 'DOZEN', 'DOZER', 'DOZES', 'DRONE', 'DROVE', 'FLOES', 'FOEHN', 'FORCE', 'FORES', 'FORGE', 'FORME', 'FORTE', 'FOSSE', 'FOXED', 'FOXES', 'FROES', 'FRORE', 'FROZE', 'GLOBE', 'GLOVE', 'GLOZE', 'GNOME', 'GODET', 'GOERS', 'GOFER', 'GOLEM', 'GOMER', 'GONEF', 'GONER', 'GORED', 'GORES', 'GORGE', 'GORSE', 'GOXES', 'GROPE', 'GROVE', 'HOERS', 'HOKED', 'HOKES', 'HOLED', 'HOLES', 'HOMED', 'HOMER', 'HOMES', 'HONED', 'HONER', 'HONES', 'HOPED', 'HOPER', 'HOPES', 'HORDE', 'HORSE', 'HOSED', 'HOSEL', 'HOSEN', 'HOSER', 'HOSES', 'HOTEL', 'HOVEL', 'HOVER', 'HOWES', 'JOKED', 'JOKER', 'JOKES', 'JOLES', 'JONES', 'JOWED', 'KOELS', 'KOPEK', 'KOPJE', 'KRONE', 'LOBED', 'LOBES', 'LODEN', 'LODES', 'LODGE', 'LOESS', 'LOGES', 'LONER', 'LONGE', 'LOPED', 'LOPER', 'LOPES', 'LORES', 'LOSEL', 'LOSER', 'LOSES', 'LOTTE', 'LOVED', 'LOVER', 'LOVES', 'LOWED', 'LOWER', 'LOWES', 'LOWSE', 'LOXED', 'LOXES', 'MODEL', 'MODEM', 'MODES', 'MOHEL', 'MOKES', 'MOLES', 'MOMES', 'MONDE', 'MONTE', 'MOPED', 'MOPER', 'MOPES', 'MOREL', 'MORES', 'MORSE', 'MOSTE', 'MOTEL', 'MOTES', 'MOTET', 'MOTTE', 'MOVED', 'MOVER', 'MOVES', 'MOWED', 'MOWER', 'NOBLE', 'NODES', 'NOELS', 'NOMEN', 'NOMES', 'NONCE', 'NONES', 'NONET', 'NOSED', 'NOSES', 'NOTED', 'NOTER', 'NOTES', 'NOVEL', 'OBJET', 'OCHER', 'OCHRE', 'OCKER', 'OCTET', 'ODDER', 'OFFED', 'OFFER', 'OFTEN', 'OFTER', 'OGLED', 'OGLER', 'OGLES', 'OGRES', 'OKEHS', 'OLDEN', 'OLDER', 'OMBER', 'OMBRE', 'OMENS', 'OMERS', 'ONCET', 'ONSET', 'OPENS', 'OPTED', 'ORBED', 'ORDER', 'ORLES', 'ORMER', 'OTHER', 'OTTER', 'OVENS', 'OVERS', 'OVERT', 'OWLET', 'OWNED', 'OWNER', 'OWSEN', 'OXTER', 'PHONE', 'POEMS', 'POETS', 'POKED', 'POKER', 'POKES', 'POLED', 'POLER', 'POLES', 'POMES', 'PONCE', 'PONES', 'POPES', 'PORED', 'PORES', 'POSED', 'POSER', 'POSES', 'POSSE', 'POWER', 'POXED', 'POXES', 'PROBE', 'PROEM', 'PROLE', 'PRONE', 'PROSE', 'PROVE', 'ROBED', 'ROBES', 'ROBLE', 'RODES', 'ROGER', 'ROLES', 'ROPED', 'ROPER', 'ROPES', 'ROSED', 'ROSES', 'ROSET', 'ROTES', 'ROTTE', 'ROVED', 'ROVEN', 'ROVER', 'ROVES', 'ROWED', 'ROWEL', 'ROWEN', 'ROWER', 'SCONE', 'SCOPE', 'SCORE', 'SHOED', 'SHOER', 'SHOES', 'SHONE', 'SHORE', 'SHOTE', 'SHOVE', 'SLOES', 'SLOPE', 'SMOKE', 'SMOTE', 'SNORE', 'SOBER', 'SOCLE', 'SOKES', 'SOLED', 'SOLES', 'SOLVE', 'SONDE', 'SONES', 'SORED', 'SOREL', 'SORER', 'SORES', 'SOWED', 'SOWER', 'SPODE', 'SPOKE', 'SPORE', 'STOKE', 'STOLE', 'STONE', 'STOPE', 'STORE', 'STOVE', 'SWORE', 'THOLE', 'THOSE', 'THROE', 'TOKED', 'TOKEN', 'TOKER', 'TOKES', 'TOLED', 'TOLES', 'TOMES', 'TONED', 'TONER', 'TONES', 'TONNE', 'TOPED', 'TOPER', 'TOPES', 'TOPHE', 'TORES', 'TORSE', 'TORTE', 'TOTED', 'TOTEM', 'TOTER', 'TOTES', 'TOWED', 'TOWEL', 'TOWER', 'TRODE', 'TROKE', 'TRONE', 'TROPE', 'TROVE', 'VOCES', 'VOLED', 'VOLES', 'VOLTE', 'VOMER', 'VOTED', 'VOTER', 'VOTES', 'VOWED', 'VOWEL', 'VOWER', 'WHOLE', 'WHORE', 'WHOSE', 'WODGE', 'WOKEN', 'WOMEN', 'WORSE', 'WOVEN', 'WOWED', 'WROTE', 'ZLOTE', 'ZONED', 'ZONER', 'ZONES'] 
OY: ['BLOWY', 'BOBBY', 'BOGGY', 'BONNY', 'BORTY', 'BOSKY', 'BOSSY', 'BOTHY', 'BROSY', 'CHOKY', 'CLOYS', 'COBBY', 'COCKY', 'COLBY', 'COLLY', 'COMFY', 'COMMY', 'CONKY', 'CORBY', 'CORKY', 'CORNY', 'COWRY', 'CRONY', 'DOBBY', 'DODGY', 'DOGGY', 'DOLLY', 'DONSY', 'DORKY', 'DORMY', 'DORTY', 'DOTTY', 'DOWDY', 'DOWNY', 'DOWRY', 'FOGGY', 'FOLKY', 'FOLLY', 'FORBY', 'FORKY', 'FORTY', 'GLORY', 'GODLY', 'GOLLY', 'GORSY', 'GRODY', 'HOBBY', 'HOLLY', 'HONKY', 'HOPPY', 'HORNY', 'HORSY', 'HOTLY', 'HOWDY', 'JOLLY', 'JOLTY', 'JOTTY', 'JOWLY', 'LOBBY', 'LOFTY', 'LOGGY', 'LOLLY', 'LOPPY', 'LORRY', 'LOSSY', 'LOWLY', 'MOGGY', 'MOLDY', 'MOLLY', 'MOMMY', 'MOSSY', 'MOTHY', 'NOBBY', 'NOBLY', 'NODDY', 'NONYL', 'OCHRY', 'OCTYL', 'ODDLY', 'ODYLS', 'PHONY', 'PLOYS', 'POCKY', 'PODGY', 'POLYP', 'POLYS', 'POMMY', 'POPPY', 'POPSY', 'PORGY', 'PORKY', 'PORNY', 'POTSY', 'POTTY', 'PROSY', 'PROXY', 'ROCKY', 'ROWDY', 'SHOWY', 'SLOYD', 'SMOKY', 'SNOWY', 'SODDY', 'SOFTY', 'SOGGY', 'SONLY', 'SONNY', 'SONSY', 'SOPHY', 'SOPPY', 'SORRY', 'STOGY', 'STONY', 'STORY', 'STROY', 'TODDY', 'TOFFY', 'TOLYL', 'TOMMY', 'TOWNY', 'TROYS', 'WOMBY', 'WOMYN', 'WONKY', 'WORDY', 'WORMY', 'WORRY', 'ZLOTY'] 
UE: ['BLUED', 'BLUER', 'BLUES', 'BLUET', 'BLUME', 'BRUME', 'BRUTE', 'BUDGE', 'BUGLE', 'BULGE', 'BURET', 'BURKE', 'BURSE', 'BUSED', 'BUSES', 'BUTES', 'BUTLE', 'BUTTE', 'CHUTE', 'CLUED', 'CLUES', 'CRUDE', 'CRUEL', 'CRUET', 'CRUSE', 'CUBEB', 'CUBED', 'CUBER', 'CUBES', 'CUKES', 'CULET', 'CULEX', 'CUPEL', 'CURED', 'CURER', 'CURES', 'CURET', 'CURSE', 'CURVE', 'CUSEC', 'CUTER', 'CUTES', 'DRUPE', 'DRUSE', 'DUCES', 'DUDED', 'DUDES', 'DUELS', 'DUETS', 'DUKED', 'DUKES', 'DULSE', 'DUNCE', 'DUNES', 'DUPED', 'DUPER', 'DUPES', 'DUPLE', 'DURED', 'DURES', 'DUVET', 'FLUED', 'FLUES', 'FLUKE', 'FLUME', 'FLUTE', 'FUDGE', 'FUELS', 'FUGLE', 'FUMED', 'FUMER', 'FUMES', 'FUMET', 'FURZE', 'FUSED', 'FUSEL', 'FUSES', 'FUZED', 'FUZES', 'GLUED', 'GLUER', 'GLUES', 'GLUME', 'GLUTE', 'GRUEL', 'GRUES', 'GRUME', 'GUDES', 'GUESS', 'GUEST', 'GULES', 'GURGE', 'HUGER', 'JUBES', 'JUDGE', 'JUKED', 'JUKES', 'JULEP', 'JUPES', 'JUREL', 'JUTES', 'KLUGE', 'KUGEL', 'LUBED', 'LUBES', 'LUCES', 'LUCRE', 'LUDES', 'LUGED', 'LUGER', 'LUGES', 'LUMEN', 'LUNES', 'LUNET', 'LUNGE', 'LURED', 'LURER', 'LURES', 'LUREX', 'LUTED', 'LUTES', 'LUXES', 'MULED', 'MULES', 'MURED', 'MURES', 'MUREX', 'MURRE', 'MUSED', 'MUSER', 'MUSES', 'MUTED', 'MUTER', 'MUTES', 'NUDER', 'NUDES', 'NUDGE', 'NUKED', 'NUKES', 'NUMEN', 'NURSE', 'PLUME', 'PRUDE', 'PRUNE', 'PUBES', 'PUCES', 'PUKED', 'PUKES', 'PULED', 'PULER', 'PULES', 'PULSE', 'PURER', 'PURGE', 'PURSE', 'PUSES', 'QUELL', 'QUERN', 'QUEST', 'RUBEL', 'RUBES', 'RUBLE', 'RUCHE', 'RUDER', 'RUERS', 'RUFFE', 'RULED', 'RULER', 'RULES', 'RUMEN', 'RUNES', 'RUSES', 'SCUTE', 'SHUTE', 'SLUED', 'SLUES', 'SPRUE', 'SPUED', 'SPUES', 'SPUME', 'SQUEG', 'STUPE', 'SUBER', 'SUCRE', 'SUERS', 'SUETS', 'SUPER', 'SUPES', 'SURER', 'SURGE', 'TRUCE', 'TRUED', 'TRUER', 'TRUES', 'TUBED', 'TUBER', 'TUBES', 'TULES', 'TULLE', 'TUNED', 'TUNER', 'TUNES', 'TUXES', 'UDDER', 'ULCER', 'UMBEL', 'UMBER', 'UMPED', 'UNCLE', 'UNDER', 'UNFED', 'UNLED', 'UNLET', 'UNMET', 'UNMEW', 'UNPEG', 'UNPEN', 'UNSET', 'UNSEW', 'UNSEX', 'UNWED', 'UNWET', 'UPEND', 'UPPED', 'UPPER', 'UPSET', 'URGED', 'URGER', 'URGES', 'URPED', 'USERS', 'USHER', 'UTTER'] 
UEY: ['BLUEY', 'CUTEY', 'GLUEY', 'MULEY', 'QUERY', 'QUEYS', 'SUETY'] 
YE: ['BLYPE', 'BYRES', 'BYTES', 'CHYLE', 'CHYME', 'CYBER', 'CYCLE', 'CYDER', 'CYMES', 'DRYER', 'DYERS', 'DYKED', 'DYKES', 'DYNEL', 'DYNES', 'FLYER', 'FLYTE', 'FRYER', 'FYCES', 'FYKES', 'FYTTE', 'GYBED', 'GYBES', 'GYRED', 'GYRES', 'GYVED', 'GYVES', 'HYMEN', 'HYPED', 'HYPER', 'HYPES', 'KYTES', 'KYTHE', 'LYRES', 'LYSED', 'LYSES', 'PHYLE', 'PLYER', 'PRYER', 'PYRES', 'PYREX', 'PYXES', 'RHYME', 'RYKED', 'RYKES', 'SHYER', 'SKYED', 'SLYER', 'SLYPE', 'SNYES', 'STYED', 'STYES', 'STYLE', 'SYCES', 'SYKES', 'SYREN', 'THYME', 'TWYER', 'TYERS', 'TYKES', 'TYNED', 'TYNES', 'TYPED', 'TYPES', 'TYRED', 'TYRES', 'TYTHE', 'WRYER', 'WYLED', 'WYLES', 'WYTED', 'WYTES', 'XYLEM', 'YECCH', 'YECHS', 'YEGGS', 'YELKS', 'YELLS', 'YELPS', 'YERKS', 'YETTS', 'YLEMS', 'ZYMES'] 
OI: ['BOCCI', 'BOILS', 'BOING', 'BOINK', 'BORIC', 'BOVID', 'BROIL', 'CHOIR', 'COCCI', 'COIFS', 'COIGN', 'COILS', 'COINS', 'COIRS', 'COLIC', 'COLIN', 'COMIC', 'COMIX', 'CONIC', 'CONIN', 'CORGI', 'COVIN', 'CROCI', 'DHOBI', 'DHOTI', 'DOING', 'DOITS', 'DOLCI', 'DOMIC', 'DROID', 'DROIT', 'FOILS', 'FOINS', 'FOIST', 'FOLIC', 'GOING', 'GONIF', 'GOPIK', 'GROIN', 'HOICK', 'HOIST', 'HONGI', 'JOINS', 'JOINT', 'JOIST', 'KOJIS', 'LOGIC', 'LOGIN', 'LOIDS', 'LOINS', 'LORIS', 'LOTIC', 'MOILS', 'MOIST', 'MOTIF', 'NOILS', 'NOIRS', 'NORIS', 'OBITS', 'ODIST', 'OHING', 'OHMIC', 'OINKS', 'OMITS', 'ONTIC', 'OPING', 'OPSIN', 'OPTIC', 'ORBIT', 'ORCIN', 'ORGIC', 'ORNIS', 'ORPIN', 'ORRIS', 'OSMIC', 'OWING', 'OXIDS', 'OXIMS', 'OXLIP', 'POIND', 'POINT', 'POLIS', 'POSIT', 'ROBIN', 'ROILS', 'ROSHI', 'ROSIN', 'ROTIS', 'SHOGI', 'SHOJI', 'SLOID', 'SODIC', 'SOILS', 'SOLDI', 'SOLID', 'SONIC', 'SOZIN', 'SPOIL', 'STOIC', 'TOILS', 'TOITS', 'TONDI', 'TONIC', 'TOPHI', 'TOPIC', 'TOPIS', 'TORIC', 'TORSI', 'TOXIC', 'TOXIN', 'TROIS', 'VOIDS', 'VOLTI', 'VOMIT', 'ZOMBI', 'ZORIL', 'ZORIS'] 
OEY: ['BOGEY', 'BONEY', 'CONEY', 'COSEY', 'COVEY', 'COZEY', 'DOGEY', 'DOPEY', 'FOGEY', 'FOLEY', 'HOKEY', 'HOLEY', 'HOMEY', 'HONEY', 'HOSEY', 'JOEYS', 'JOKEY', 'MONEY', 'MOPEY', 'MOSEY', 'MOTEY', 'NOSEY', 'OBEYS', 'ONERY', 'POESY', 'POGEY', 'POKEY', 'ROPEY', 'TONEY'] 
OIE: ['BOGIE', 'BOITE', 'COSIE', 'COZIE', 'DOBIE', 'DOGIE', 'DOWIE', 'DOXIE', 'FOGIE', 'HOISE', 'HOMIE', 'KOINE', 'MOIRE', 'MONIE', 'MOVIE', 'MOXIE', 'NOISE', 'OGIVE', 'OILED', 'OILER', 'OLDIE', 'OLIVE', 'OPINE', 'ORIEL', 'OSIER', 'OVINE', 'OXIDE', 'OXIME', 'POISE', 'TOILE', 'TOWIE', 'VOGIE', 'VOICE', 'VOILE', 'ZOWIE'] 
OU: ['BOGUS', 'BOLUS', 'BONUS', 'BOSUN', 'BOUGH', 'BOUND', 'BOURG', 'BOURN', 'BOUTS', 'CLOUD', 'CLOUR', 'CLOUT', 'CONUS', 'CORNU', 'COUCH', 'COUGH', 'COULD', 'COUNT', 'COUPS', 'COURT', 'COUTH', 'CROUP', 'DONUT', 'DOUBT', 'DOUGH', 'DOUMS', 'DROUK', 'FLOUR', 'FLOUT', 'FOCUS', 'FONDU', 'FORUM', 'FOULS', 'FOUND', 'FOUNT', 'FOURS', 'GHOUL', 'GLOUT', 'GOURD', 'GOUTS', 'GROUP', 'GROUT', 'HOCUS', 'HOKKU', 'HOKUM', 'HOUND', 'HOURS', 'JORUM', 'JOUKS', 'JOUST', 'KHOUM', 'KNOUT', 'KOMBU', 'KORUN', 'LOCUM', 'LOCUS', 'LOTUS', 'LOUGH', 'LOUPS', 'LOURS', 'LOUTS', 'MODUS', 'MOGUL', 'MOHUR', 'MOMUS', 'MOUCH', 'MOULD', 'MOULT', 'MOUND', 'MOUNT', 'MOURN', 'MOUTH', 'NODUS', 'NOTUM', 'NOUNS', 'OCCUR', 'OUGHT', 'OUPHS', 'OUSTS', 'POUCH', 'POUFF', 'POUFS', 'POULT', 'POUND', 'POURS', 'POUTS', 'PROUD', 'ROUGH', 'ROUND', 'ROUPS', 'ROUST', 'ROUTH', 'ROUTS', 'SCOUR', 'SCOUT', 'SHOUT', 'SNOUT', 'SOLUM', 'SOLUS', 'SORUS', 'SOUGH', 'SOUKS', 'SOULS', 'SOUND', 'SOUPS', 'SOURS', 'SOUTH', 'SPOUT', 'STOUP', 'STOUR', 'STOUT', 'SWOUN', 'THOUS', 'TOFUS', 'TOLUS', 'TONUS', 'TORUS', 'TOUCH', 'TOUGH', 'TOURS', 'TOUTS', 'TROUT', 'VODUN', 'VOUCH', 'VROUW', 'WOFUL', 'WOULD', 'WOUND', 'ZOUKS'] 
OEA: ['BOHEA', 'FOVEA', 'OBEAH', 'OCEAN', 'OCREA', 'OMEGA', 'OPERA', 'OREAD', 'TOEAS', 'ZOEAL', 'ZOEAS'] 
OOY: ['BOOBY', 'BOODY', 'BOOGY', 'BOOMY', 'BOOTY', 'BOOZY', 'COOKY', 'COOLY', 'DOODY', 'DOOLY', 'DOOMY', 'DOOZY', 'FOOTY', 'GOODY', 'GOOFY', 'GOOKY', 'GOONY', 'GOOPY', 'GOOSY', 'HOODY', 'HOOKY', 'HOOLY', 'HOOTY', 'KOOKY', 'LOOBY', 'LOONY', 'LOOPY', 'MOODY', 'MOONY', 'MOORY', 'NOOKY', 'OLOGY', 'POBOY', 'POOFY', 'ROOKY', 'ROOMY', 'ROOTY', 'SOOTY', 'WOODY', 'WOOLY', 'WOOZY', 'ZOOTY'] 
OOE: ['BOOED', 'BOOZE', 'COOED', 'COOER', 'GOOSE', 'LOOED', 'LOOSE', 'MOOED', 'MOOSE', 'NOOSE', 'OBOES', 'OBOLE', 'OOHED', 'OOZED', 'OOZES', 'OZONE', 'POOED', 'POOVE', 'ROOSE', 'WOOED', 'WOOER'] 
OUE: ['BOULE', 'BOUSE', 'COUDE', 'COUPE', 'DOUCE', 'DOUSE', 'GOUGE', 'HOUSE', 'JOULE', 'LOUPE', 'LOUSE', 'MOUES', 'MOUSE', 'OUNCE', 'OUPHE', 'OUSEL', 'OUTED', 'OUTER', 'OUTRE', 'OUZEL', 'OVULE', 'ROGUE', 'ROQUE', 'ROUEN', 'ROUES', 'ROUGE', 'ROUSE', 'ROUTE', 'SOUSE', 'TOGUE', 'TOQUE', 'TOUSE', 'VOGUE'] 
OUY: ['BOUSY', 'GOUTY', 'LOURY', 'LOUSY', 'MOUSY', 'OUTBY', 'POUTY', 'ROUPY', 'SOUPY'] 
OYA: ['BOYAR', 'BOYLA', 'HOYAS', 'LOYAL', 'ROYAL', 'SOYAS'] 
OYO: ['BOYOS', 'TOYON', 'TOYOS'] 
UI: ['BRUIN', 'BRUIT', 'BUFFI', 'BUILD', 'BUILT', 'BURIN', 'CUBIC', 'CUBIT', 'CUIFS', 'CUING', 'CUISH', 'CULTI', 'CUMIN', 'CUPID', 'CUTIN', 'CUTIS', 'DHUTI', 'DRUID', 'DUITS', 'FLUID', 'FRUIT', 'FUJIS', 'FUNDI', 'FUNGI', 'FUSIL', 'FUZIL', 'GUIDS', 'GUILD', 'GUILT', 'HUMIC', 'HUMID', 'KRUBI', 'KUFIS', 'KUKRI', 'LUCID', 'LUDIC', 'LUNGI', 'LUPIN', 'LURID', 'MUCID', 'MUCIN', 'MUFTI', 'MUJIK', 'MUNIS', 'MURID', 'MUSIC', 'PUBIC', 'PUBIS', 'PUDIC', 'PULIK', 'PULIS', 'PUNJI', 'PUPIL', 'PURIN', 'PURIS', 'PUTTI', 'QUBIT', 'QUICK', 'QUIDS', 'QUIFF', 'QUILL', 'QUILT', 'QUINS', 'QUINT', 'QUIPS', 'QUIRK', 'QUIRT', 'QUITS', 'RUING', 'RUINS', 'RUNIC', 'RUTIN', 'SCUDI', 'SQUIB', 'SQUID', 'SUING', 'SUINT', 'SUITS', 'SULCI', 'SUSHI', 'TULIP', 'TUMID', 'TUNIC', 'TUPIK', 'TUTTI', 'UNBID', 'UNDID', 'UNFIT', 'UNFIX', 'UNHIP', 'UNITS', 'UNLIT', 'UNMIX', 'UNPIN', 'UNRIG', 'UNRIP', 'UNTIL', 'UNWIT', 'UNZIP', 'UPLIT', 'URSID', 'USING', 'ZUZIM'] 
UA: ['BUBAL', 'BUBBA', 'BULLA', 'BUNAS', 'BURAN', 'BURAS', 'BURKA', 'BURQA', 'BURSA', 'CHUFA', 'CRURA', 'CULPA', 'CUPPA', 'DUADS', 'DUALS', 'DUCAL', 'DUCAT', 'DUMAS', 'DUMKA', 'DUNAM', 'DURAL', 'DURAS', 'DURRA', 'FUBAR', 'FUGAL', 'FURAN', 'GUANS', 'GUARD', 'GUARS', 'GULAG', 'GULAR', 'GUMMA', 'GUTTA', 'HULAS', 'HUMAN', 'HUZZA', 'JUBAS', 'JUDAS', 'JUGAL', 'JUNTA', 'JURAL', 'JURAT', 'KULAK', 'KURTA', 'LUFFA', 'LUMAS', 'LUNAR', 'LUNAS', 'MUDRA', 'MULLA', 'MURAL', 'MURAS', 'MURRA', 'MUSCA', 'NUCHA', 'PRUTA', 'PUCKA', 'PUJAH', 'PUJAS', 'PUKKA', 'PUMAS', 'PUNAS', 'PUNKA', 'PUPAL', 'PUPAS', 'PURDA', 'QUACK', 'QUADS', 'QUAFF', 'QUAGS', 'QUALM', 'QUANT', 'QUARK', 'QUART', 'QUASH', 'QUASS', 'RUGAL', 'RUMBA', 'RURAL', 'SCUBA', 'SCUTA', 'SKUAS', 'SPUTA', 'SQUAB', 'SQUAD', 'SQUAT', 'SQUAW', 'STUPA', 'SUBAH', 'SUBAS', 'SUGAR', 'SULFA', 'SUMAC', 'SUMMA', 'SUNNA', 'SUPRA', 'SURAH', 'SURAL', 'SURAS', 'SURRA', 'SUTRA', 'SUTTA', 'THUJA', 'TSUBA', 'TUBAL', 'TUBAS', 'TUFAS', 'TUNAS', 'UHLAN', 'ULANS', 'ULNAD', 'ULNAR', 'ULNAS', 'ULPAN', 'ULTRA', 'ULVAS', 'UMBRA', 'UNAPT', 'UNARM', 'UNBAN', 'UNBAR', 'UNCAP', 'UNHAT', 'UNJAM', 'UNMAN', 'URBAN', 'VULVA'] 
UY: ['BUBBY', 'BUDDY', 'BUFFY', 'BUGGY', 'BULGY', 'BULKY', 'BULLY', 'BUMPY', 'BUNNY', 'BUPPY', 'BURLY', 'BURRY', 'BUSBY', 'BUSHY', 'BUSTY', 'BUTTY', 'BUTYL', 'CUBBY', 'CUDDY', 'CULLY', 'CUPPY', 'CURDY', 'CURLY', 'CURRY', 'CURVY', 'CUSHY', 'CUTTY', 'DUCHY', 'DUCKY', 'DUDDY', 'DULLY', 'DUMKY', 'DUMMY', 'DUMPY', 'DUNGY', 'DUSKY', 'DUSTY', 'FLUKY', 'FLUTY', 'FLUYT', 'FUBSY', 'FUDDY', 'FUGGY', 'FULLY', 'FUNKY', 'FUNNY', 'FURRY', 'FURZY', 'FUSSY', 'FUSTY', 'FUZZY', 'GULFY', 'GULLY', 'GULPY', 'GUMMY', 'GUNKY', 'GUNNY', 'GUPPY', 'GURRY', 'GUSHY', 'GUSSY', 'GUSTY', 'GUTSY', 'GUTTY', 'HUBBY', 'HUFFY', 'HULKY', 'HUMPY', 'HUNKY', 'HURLY', 'HURRY', 'HUSKY', 'HUSSY', 'JUMPY', 'JUNKY', 'JUTTY', 'KUMYS', 'LUCKY', 'LUMPY', 'LUSTY', 'MUCKY', 'MUDDY', 'MUGGY', 'MUHLY', 'MUMMY', 'MURKY', 'MURRY', 'MUSHY', 'MUSKY', 'MUSSY', 'MUSTY', 'MUZZY', 'NUBBY', 'NUTSY', 'NUTTY', 'PLUMY', 'PUDGY', 'PUFFY', 'PUGGY', 'PULPY', 'PUNKY', 'PUNNY', 'PUNTY', 'PUPPY', 'PURSY', 'PURTY', 'PUSHY', 'PUSSY', 'PUTTY', 'RUBBY', 'RUDDY', 'RUGBY', 'RUMMY', 'RUNNY', 'RUNTY', 'RUSHY', 'RUSTY', 'RUTTY', 'SPUMY', 'STUDY', 'SUCKY', 'SUDSY', 'SULKY', 'SULLY', 'SUNNY', 'SURFY', 'SURGY', 'SURLY', 'TRULY', 'TUBBY', 'TUFTY', 'TUMMY', 'TUNNY', 'TURFY', 'TUSHY', 'TUTTY', 'UPDRY', 'VUGGY', 'WUSSY'] 
UU: ['BUBUS', 'BUTUT', 'CUTUP', 'DUFUS', 'DURUM', 'FUCUS', 'FUGUS', 'GURUS', 'HUMUS', 'JUGUM', 'JUJUS', 'JUKUS', 'KUDUS', 'KUDZU', 'KURUS', 'LULUS', 'LUPUS', 'LUSUS', 'MUCUS', 'MUMUS', 'PUPUS', 'RUBUS', 'SULUS', 'SUNUP', 'TUTUS', 'UNCUS', 'UNCUT', 'USURP', 'WUSHU'] 
UO: ['BUCKO', 'BUFFO', 'BUNCO', 'BUNKO', 'BURRO', 'BUXOM', 'CRUOR', 'CUSSO', 'DUMBO', 'DUROC', 'DUROS', 'FLUOR', 'FUNGO', 'FUROR', 'FUTON', 'GLUON', 'GUMBO', 'GUSTO', 'HULLO', 'HUMOR', 'JUCOS', 'JUDOS', 'JUMBO', 'JUNCO', 'JUNTO', 'JUPON', 'JUROR', 'KUDOS', 'KUSSO', 'MUCHO', 'MUCOR', 'MUCRO', 'MUNGO', 'MUONS', 'MUTON', 'PUNTO', 'PUTON', 'PUTTO', 'QUODS', 'QUOLL', 'QUOTH', 'RUMOR', 'SCUDO', 'SUDOR', 'SULFO', 'SUMOS', 'TUMOR', 'TURBO', 'TUTOR', 'UDONS', 'UMBOS', 'UNBOX', 'UNCOS', 'UNGOT', 'UNWON', 'UPBOW', 'UPDOS', 'VULGO'] 
UYA: ['BUNYA', 'THUYA'] 
UOY: ['BUOYS', 'UNCOY'] 
UEO: ['BUTEO', 'UREDO'] 
UYE: ['BUYER', 'GUYED', 'TUYER', 'UPBYE'] 
YA: ['BYLAW', 'CYANS', 'CYCAD', 'CYCAS', 'CYMAR', 'CYMAS', 'DRYAD', 'DYADS', 'GYRAL', 'HYDRA', 'HYLAS', 'HYPHA', 'HYRAX', 'KYACK', 'KYAKS', 'KYARS', 'KYATS', 'LYARD', 'LYART', 'LYCRA', 'LYSSA', 'LYTTA', 'MYLAR', 'MYNAH', 'MYNAS', 'PHYLA', 'PYRAN', 'RHYTA', 'SYLVA', 'TRYMA', 'TYPAL', 'XYLAN', 'YACHT', 'YACKS', 'YAFFS', 'YANGS', 'YANKS', 'YARDS', 'YARNS', 'YAWLS', 'YAWNS', 'YAWPS', 'YCLAD'] 
Y: ['BYRLS', 'CRYPT', 'CYSTS', 'GHYLL', 'GLYPH', 'HYMNS', 'LYMPH', 'LYNCH', 'MYRRH', 'MYTHS', 'NYMPH', 'PSYCH', 'RYNDS', 'SYLPH', 'SYNCH', 'SYNCS', 'SYNTH', 'SYPHS', 'TRYST', 'TYPPS', 'WYNDS', 'WYNNS', 'XYSTS'] 
YI: ['BYSSI', 'CYLIX', 'CYNIC', 'DYING', 'HYING', 'KYLIX', 'LYING', 'LYRIC', 'LYSIN', 'LYSIS', 'LYTIC', 'MYSID', 'PYINS', 'PYRIC', 'PYXIS', 'STYLI', 'SYLIS', 'THYMI', 'TYING', 'TYPIC', 'VYING', 'XYSTI', 'YILLS', 'YIRDS', 'YIRRS', 'YIRTH'] 
YAY: ['BYWAY', 'YABBY'] 
EAE: ['CEASE', 'DEAVE', 'EAGER', 'EAGLE', 'EAGRE', 'EARED', 'EASED', 'EASEL', 'EASES', 'EATEN', 'EATER', 'EAVED', 'EAVES', 'ELATE', 'ENATE', 'ERASE', 'ETAPE', 'EVADE', 'FEASE', 'FEAZE', 'HEAVE', 'LEASE', 'LEAVE', 'PEACE', 'PEAGE', 'PEASE', 'REAVE', 'SETAE', 'TEASE', 'TELAE', 'VENAE', 'WEAVE'] 
EIA: ['CEIBA', 'CERIA', 'ENTIA', 'ERICA', 'FERIA', 'MEDIA', 'REDIA', 'RETIA', 'SEPIA', 'TELIA', 'TENIA', 'XENIA'] 
EII: ['CEILI', 'GENII', 'MEDII', 'TEIID'] 
IAO: ['CHIAO', 'DIAZO', 'IMAGO', 'MIAOW', 'PIANO'] 
IU: ['CHIRU', 'FICHU', 'FICUS', 'FILUM', 'HILUM', 'HILUS', 'ICTUS', 'IGLUS', 'INCUR', 'INCUS', 'INPUT', 'INRUN', 'INURN', 'LINUM', 'MINUS', 'MIXUP', 'NIDUS', 'NISUS', 'PICUL', 'PILUS', 'PINUP', 'RISUS', 'SINUS', 'SIRUP', 'SITUP', 'SITUS', 'VIRTU', 'VIRUS'] 
IIA: ['CILIA', 'ILIAC', 'ILIAD', 'ILIAL', 'IXIAS', 'MILIA', 'TIBIA', 'VIGIA'] 
OAA: ['COALA', 'KOALA', 'OMASA'] 
OAY: ['COALY', 'COPAY', 'FOAMY', 'FORAY', 'HOAGY', 'HOARY', 'LOAMY', 'MORAY', 'NOWAY', 'OFAYS', 'OKAYS', 'ONLAY', 'OVARY', 'SOAPY', 'TOADY', 'TODAY', 'TOKAY'] 
OAI: ['COATI', 'KORAI', 'OASIS', 'OKAPI', 'PSOAI', 'STOAI'] 
OIA: ['COBIA', 'CORIA', 'FOLIA', 'GONIA', 'LOGIA', 'MOIRA', 'NORIA', 'OBIAS', 'OHIAS', 'OSSIA', 'OSTIA', 'PODIA', 'VOILA'] 
OOA: ['COCOA', 'HOOKA', 'LOOFA', 'MOOLA'] 
OAE: ['COMAE', 'COXAE', 'MORAE', 'NOVAE', 'OAKEN', 'OARED', 'OASES', 'OATEN', 'OATER', 'OAVES', 'ORATE', 'OVATE', 'PSOAE', 'SOAVE', 'STOAE', 'TOGAE', 'ZONAE'] 
OOEE: ['COOEE'] 
OOEY: ['COOEY', 'GOOEY', 'HOOEY', 'LOOEY', 'SOOEY', 'ZOOEY'] 
OYE: ['COYED', 'COYER', 'DOYEN', 'FOYER', 'HOYLE', 'JOYED', 'ODYLE', 'OYERS', 'TOYED', 'TOYER'] 
OYY: ['COYLY', 'DOYLY'] 
OYU: ['COYPU', 'SHOYU', 'SOYUZ'] 
: ['CRWTH', 'PHPHT', ''] 
UIA: ['CURIA', 'DULIA', 'NUBIA', 'UMIAC', 'UMIAK', 'UMIAQ', 'UNCIA', 'URBIA', 'URIAL'] 
UIE: ['CURIE', 'CUTIE', 'GUIDE', 'GUILE', 'GUISE', 'JUICE', 'NUDIE', 'QUIET', 'QUIRE', 'QUITE', 'SUITE', 'UNITE', 'UNTIE', 'URINE', 'UTILE'] 
UIO: ['CURIO', 'FUGIO', 'GUIRO', 'UNION'] 
UEE: ['CUVEE', 'FUSEE', 'FUZEE', 'PUREE', 'QUEEN', 'QUEER', 'RUPEE', 'SUEDE', 'TUTEE', 'UNDEE'] 
YAO: ['CYANO', 'YAPOK', 'YAPON'] 
YO: ['CYCLO', 'CYMOL', 'CYTON', 'GYRON', 'GYROS', 'HYDRO', 'HYPOS', 'HYSON', 'NYLON', 'PYLON', 'PYROS', 'RYOTS', 'SYNOD', 'SYSOP', 'TYPOS', 'TYROS', 'XYLOL', 'YOCKS', 'YODHS', 'YOGHS', 'YOLKS', 'YOWLS'] 
YAE: ['CYMAE', 'LYASE', 'YAGER', 'YAMEN', 'YARER', 'YAWED'] 
EAI: ['DEAIR', 'ELAIN', 'EMAIL', 'SERAI', 'TERAI'] 
EYE: ['DEBYE', 'EMYDE', 'EYERS', 'EYRES', 'FEYER', 'KEYED', 'REDYE'] 
EOY: ['DECOY', 'DEOXY', 'EBONY', 'ENJOY', 'ENVOY', 'EPOXY', 'PEONY', 'SEPOY', 'TEPOY'] 
EUE: ['DEUCE', 'EDUCE', 'ELUDE', 'ELUTE', 'ENDUE', 'ENSUE', 'ENURE', 'ETUDE', 'EXUDE', 'FEUED', 'NEUME', 'REUSE', 'REVUE', 'SEGUE', 'VENUE'] 
IEY: ['DICEY', 'DIKEY', 'FIERY', 'JIVEY', 'LIMEY', 'LINEY', 'PIETY', 'PINEY', 'RILEY', 'SKIEY', 'VIEWY', 'WIFEY', 'WINEY'] 
IEE: ['DIENE', 'HIREE', 'LIEGE', 'LIEVE', 'NIECE', 'NIEVE', 'PIECE', 'SIEGE', 'SIEVE', 'SIREE'] 
OIY: ['DOILY', 'NOILY', 'NOISY', 'ROILY'] 
OEE: ['DONEE', 'OBESE', 'OGEES', 'TOPEE'] 
OUA: ['DOULA', 'DOUMA', 'DOURA', 'JOUAL', 'LOUMA'] 
YY: ['DRYLY', 'FLYBY', 'GYPSY', 'MYTHY', 'PYGMY', 'SHYLY', 'SLYLY', 'STYMY', 'THYMY', 'WRYLY', 'XYLYL'] 
UOI: ['DUOMI', 'QUOIN', 'QUOIT'] 
UOO: ['DUOMO'] 
YEY: ['DYKEY', 'SKYEY', 'TYPEY', 'YECHY'] 
EOO: ['EBOOK'] 
EEA: ['EDEMA', 'ENEMA', 'PEREA', 'VEENA'] 
EEIE: ['EERIE'] 
EIO: ['EIDOS', 'EIKON', 'HELIO'] 
EOI: ['ELOIN', 'ENOKI', 'ENVOI', 'EOSIN', 'GEOID', 'REOIL', 'TELOI'] 
EOE: ['ELOPE', 'EMOTE', 'EPODE', 'ERODE', 'EROSE', 'EVOKE', 'GEODE', 'LEONE', 'PEKOE'] 
EEE: ['EMCEE', 'EMEER', 'EPEES', 'ETWEE', 'FEEZE', 'GEESE', 'GELEE', 'HEEZE', 'KEEVE', 'LEVEE', 'MELEE', 'PEEVE', 'PEWEE', 'REEVE', 'RESEE', 'TEPEE'] 
EEU: ['EMEUS'] 
EUI: ['ENNUI', 'EQUID', 'EQUIP', 'ETUIS'] 
EUA: ['EQUAL', 'FEUAR', 'GENUA', 'LEHUA', 'TEGUA'] 
EUO: ['ERUGO', 'EUROS'] 
EYA: ['ETYMA', 'EYASS', 'EYRAS'] 
EYI: ['EYING', 'EYRIR'] 
EYIE: ['EYRIE'] 
EYY: ['FEYLY'] 
IUE: ['FIQUE', 'GIGUE', 'IMBUE', 'INDUE', 'INURE', 'ISSUE', 'PIQUE'] 
OIO: ['FOLIO', 'OLIOS', 'ONION', 'POLIO'] 
UUE: ['FUGUE', 'TUQUE', 'UNDUE', 'USQUE'] 
AYY: ['GAYLY'] 
EOA: ['GENOA'] 
OYI: ['GOYIM'] 
UAO: ['GUACO', 'GUANO'] 
UAA: ['GUAVA', 'RUANA', 'ULAMA'] 
UYO: ['GUYOT'] 
YOA: ['GYOZA', 'MYOMA', 'YOGAS'] 
YU: ['GYRUS', 'SYRUP', 'YUCCH', 'YUCKS', 'YURTS'] 
AIU: ['HAIKU', 'NAIRU'] 
AYEY: ['HAYEY'] 
OUI: ['HOURI', 'LOUIS', 'OCULI'] 
YEA: ['HYENA', 'LYCEA', 'YEAHS', 'YEANS', 'YEARN', 'YEARS', 'YEAST', 'YENTA', 'YERBA'] 
YOI: ['HYOID', 'MYOID', 'PYOID', 'YOGIC', 'YOGIN', 'YOGIS', 'YOMIM', 'YONIC', 'YONIS'] 
IIY: ['ICILY'] 
IEA: ['IDEAL', 'IDEAS', 'ILEAC', 'ILEAL', 'PIETA', 'PILEA', 'TINEA'] 
IIO: ['IDIOM', 'IDIOT', 'IMIDO', 'IMINO', 'INION'] 
IOO: ['IGLOO', 'IROKO'] 
IEU: ['ILEUM', 'ILEUS', 'LIEUS', 'SIEUR'] 
IIU: ['ILIUM'] 
IAE: ['IMAGE', 'INANE', 'IRADE', 'IRATE', 'LIANE', 'MINAE', 'VITAE'] 
IAU: ['IMAUM', 'MIAUL', 'PILAU'] 
IYE: ['INBYE'] 
IOI: ['IODIC', 'IODID', 'IODIN', 'IONIC'] 
IOY: ['IRONY', 'IVORY'] 
IEI: ['ISSEI', 'KIBEI', 'NISEI', 'PILEI'] 
UIY: ['JUICY', 'UNIFY', 'UNITY'] 
YIE: ['KYRIE', 'PYXIE', 'YIELD', 'YIKES', 'YINCE', 'YIPES'] 
AYU: ['LAYUP'] 
IAA: ['LIANA', 'RIATA', 'TIARA'] 
OOI: ['LOGOI', 'NOMOI', 'OBOLI', 'OOTID', 'OVOID', 'OVOLI', 'POORI', 'TOPOI', 'ZOOID'] 
OOIE: ['LOOIE', 'OORIE'] 
OUIE: ['LOUIE', 'OURIE'] 
UAU: ['LUAUS', 'UNAUS'] 
UEA: ['LUTEA', 'QUEAN', 'ULEMA', 'UREAL', 'UREAS', 'USNEA', 'UVEAL', 'UVEAS'] 
YEE: ['LYCEE', 'SYCEE', 'TYEES', 'YENTE', 'YESES'] 
EOU: ['MEOUS'] 
IAOU: ['MIAOU'] 
IEO: ['MIMEO', 'VIDEO', 'VIREO'] 
YOE: ['MYOPE', 'YODEL', 'YODLE', 'YOKED', 'YOKEL', 'YOKES', 'YORES', 'YOWED', 'YOWES'] 
YOY: ['MYOPY', 'YOLKY'] 
YAA: ['NYALA'] 
OAU: ['OAKUM'] 
OEI: ['OBELI', 'OLEIC', 'OLEIN', 'SOLEI'] 
OEO: ['ODEON', 'OLEOS', 'RODEO', 'ROMEO'] 
OEU: ['ODEUM', 'OLEUM'] 
OIU: ['ODIUM', 'ONIUM', 'OPIUM', 'POILU'] 
OOU: ['ODOUR', 'VODOU'] 
OIIA: ['OIDIA'] 
OII: ['ORIBI', 'TORII'] 
OUO: ['OUTDO', 'OUTGO', 'OUZOS'] 
OOO: ['OVOLO'] 
OEYE: ['OXEYE'] 
AEU: ['PAREU'] 
AYEE: ['PAYEE'] 
OYOU: ['POYOU'] 
UAE: ['PUPAE', 'QUAKE', 'QUALE', 'QUARE', 'QUATE', 'RUGAE', 'SUAVE', 'TUBAE', 'UKASE', 'ULNAE', 'URARE', 'URASE', 'URATE', 'URSAE', 'USAGE'] 
UAI: ['QUAIL', 'QUAIS', 'QUASI', 'UMAMI', 'UNAIS', 'URARI'] 
UAY: ['QUAKY', 'QUAYS', 'UNARY', 'UNLAY', 'UNSAY'] 
UEUE: ['QUEUE'] 
UIU: ['QUIPU'] 
UOA: ['QUOTA'] 
UOE: ['QUOTE'] 
EAA: ['REATA'] 
EUY: ['REBUY'] 
IYA: ['RIYAL'] 
YIY: ['TYIYN'] 
UAEI: ['URAEI'] 
UEI: ['UREIC', 'UTERI'] 
UUA: ['USUAL', 'UVULA'] 
UUY: ['USURY'] 
YAI: ['YAGIS', 'YAIRD'] 
YAOO: ['YAHOO'] 
YAU: ['YAMUN', 'YAUDS', 'YAULD', 'YAUPS'] 
YAEY: ['YAWEY'] 
YEI: ['YETIS'] 
YEU: ['YEUKS'] 
YEUY: ['YEUKY'] 
YOO: ['YOBBO'] 
YOEE: ['YOGEE'] 
YOU: ['YOUNG', 'YOURN', 'YOURS', 'YOUTH'] 
YOUE: ['YOUSE'] 
YOIE: ['YOWIE'] 
YUA: ['YUANS', 'YUCAS', 'YUCCA', 'YUGAS', 'YULAN', 'YURTA'] 
YUY: ['YUCKY', 'YUKKY', 'YUMMY', 'YUPPY'] 
YUE: ['YULES'] 
YUO: ['YUPON'] 
OEAE: ['ZOEAE'] 
